Name,Id,TotalNumRide,TotalNumGetOff,NumRideByCard,NumGetOffByCard,NumRideByCash,AveNumGetOff
(구)국제여객터미널,35051,71,1921,24,1921,47,64
(구)국제여객터미널,35052,2520,37,2444,37,76,82
(주)경동세라믹스,89146,318,14,316,14,2,10
(주)경인양행앞,42096,982,956,965,956,17,62
(주)경인양행앞,42097,1423,3510,1388,3510,35,159
(주)대한특수금속,39050,1150,76,1127,76,23,39
(주)두남,39135,108,14,108,14,0,3
(주)세모입구(린나이코리아),37585,1367,1503,1355,1503,12,92
(주)세모입구(린나이코리아),40893,349,604,348,604,1,30
(주)스킨이데아,89388,149,192,149,192,0,11
(주)스킨이데아,89389,628,2,622,2,6,20
(주)씨피엔텍,39133,516,3691,510,3691,6,135
(주)씨피엔텍,39134,2291,390,2278,390,13,86
(주)창원,39029,3693,3363,3662,3363,31,227
(주)창원,39030,4324,3632,4313,3632,11,256
(주)하나금속,39124,11,10,11,10,0,0
17사단.다임메가타운,40895,1985,4438,1941,4438,44,207
17사단입구,40832,12,550,5,550,7,18
2001아울렛,40154,3616,5691,3557,5691,59,300
2001아울렛,40159,32488,14024,31955,14024,533,1500
2001아울렛,40162,11931,22776,11596,22776,335,1119
2001아울렛부평점,40158,5027,2087,4874,2087,153,229
2차풍림아이원,42584,39,12139,32,12139,7,392
3단지,40736,279,2271,268,2271,11,82
3단지관리사무소,40107,2634,618,2619,618,15,104
41번구종점,42174,2064,6186,2021,6186,43,266
510번차고지,36145,953,349,925,349,28,42
540번종점,39470,3666,28,3564,28,102,119
6공단사거리,37577,393,2633,382,2633,11,97
6공단입구,37442,639,978,616,978,23,52
6공단입구,37443,1284,1825,1227,1825,57,100
8부두,35181,343,3082,303,3082,40,110
8부두,35182,1845,2654,1758,2654,87,145
CJ인천2공장,35591,162,3295,154,3295,8,111
CJ인천2공장,35592,2627,83,2604,83,23,87
E편한세상,42453,3558,2674,3451,2674,107,201
E편한세상,42649,1311,2569,1289,2569,22,125
E편한세상,42726,2851,1415,2804,1415,47,137
GM물류센터,40568,469,1381,456,1381,13,59
GS25편의점,36142,860,1973,812,1973,48,91
GS내리주유소,44147,1,0,1,0,0,0
GS칼텍스,35168,657,61,621,61,36,23
GS칼텍스,35557,11,2709,11,2709,0,87
GS칼텍스,89220,64,144,60,144,4,6
GS칼텍스,89224,64,1472,61,1472,3,49
GS칼텍스주유소,39814,137,20,133,20,4,5
HD현대인프라코어,36081,741,1551,732,1551,9,73
HD현대인프라코어,36083,2119,1037,2086,1037,33,101
HD현대인프라코어후문,36077,36,658,8,658,28,22
HD현대인프라코어후문,36078,4030,894,4016,894,14,158
JC회관,37383,4358,4366,4261,4366,97,281
KCC아파트,42391,1638,953,1595,953,43,83
KG스틸,42008,2855,4891,2819,4891,36,249
KTX광명역4번출구,58057,153,6,153,6,0,5
KT부평지사,40381,11143,6499,10904,6499,239,569
KT부평지사,40384,6524,13394,6393,13394,131,642
KT서인천지사,42932,1693,2785,1667,2785,26,144
KT서인천지사,42933,1741,1023,1700,1023,41,89
KT송도지점,38568,487,307,476,307,11,25
KT온수분국,43523,608,337,576,337,32,30
KT인천공항지사,35095,312,75,307,75,5,12
KT인천공항지사,35109,8542,3092,7937,3092,605,375
KT인천지사,37415,6361,5065,6191,5065,170,368
KT인천지사,39319,9476,4610,9270,4610,206,454
KT중동지사,55081,813,179,795,179,18,32
KT중동지사,55082,202,1114,193,1114,9,42
LG마그나,89029,6009,1770,6003,1770,6,250
LG마그나,89264,2464,5532,2457,5532,7,257
LG물류센터,39043,284,151,281,151,3,14
LG물류센터,39044,55,386,55,386,0,14
LG아파트후문,42616,442,40,440,40,2,15
LG아파트후문,42617,11,200,11,200,0,6
LG전자(주),42297,4842,3268,4808,3268,34,261
LH1단지,35494,7282,3621,7077,3621,205,351
LH1단지,35495,3454,4639,3285,4639,169,261
LH49단지행복주택아파트,35768,445,768,444,768,1,39
LH49단지행복주택아파트,35769,1373,869,1348,869,25,72
LH7단지,35451,2494,2459,2421,2459,73,159
LH7단지,35452,2911,2950,2819,2950,92,189
LH미추홀3단지,37222,2971,6300,2803,6300,168,299
LH미추홀3단지,37635,6638,3252,6539,3252,99,319
LH웨스턴블루힐정문,89184,806,2383,798,2383,8,102
LH웨스턴블루힐정문,89185,3875,4279,3798,4279,77,263
NKG물류센터,89212,277,44,272,44,5,10
SK.GS주유소,89230,1348,1725,1340,1725,8,99
SK.GS주유소,89231,1665,1416,1651,1416,14,99
SKLPG충전사업소,35636,575,21,542,21,33,19
SKLPG충전사업소,35638,147,646,1,646,146,25
SK뷰아파트,42888,1684,6228,1651,6228,33,255
SK뷰아파트,42889,8407,1201,7841,1201,566,309
SK스카이뷰,37601,477,28150,420,28150,57,923
SK스카이뷰104동,37587,9236,62,9167,62,69,299
SK스카이뷰109동,37607,7590,87,7507,87,83,247
SK인천석유화학,42767,1226,695,1210,695,16,61
SK인천석유화학,42768,268,819,267,819,1,35
SK주유소,42956,603,456,591,456,12,34
SK주유소앞,35287,2069,132,2042,132,27,71
SK주유소앞,35539,100,2639,91,2639,9,88
SK충전소,35085,74,2887,29,2887,45,95
e편한세상 정문,38624,19401,832,19081,832,320,652
e편한세상(109동 앞),32062,759,1451,748,1451,11,71
e편한세상(109동앞),38643,1271,569,1202,569,69,59
e편한세상1차(정문),35662,625,1225,592,1225,33,59
e편한세상1차(정문),35663,1781,461,1761,461,20,72
e편한세상계양,41037,14784,3519,14660,3519,124,590
e편한세상계양,41038,5177,12974,5068,12974,109,585
e편한세상영종센텀베뉴정문,35510,1053,3489,1028,3489,25,146
e편한세상영종오션하임,35674,2052,1522,2019,1522,33,115
e편한세상영종오션하임,35761,771,1183,759,1183,12,63
e편한세상영종하늘도시,35646,332,568,324,568,8,29
e편한세상영종하늘도시,35647,201,342,183,342,18,17
gym80fitness,37081,2480,883,2428,883,52,108
가경공원,89365,999,719,991,719,8,55
가구단지사거리,37455,3718,5492,3644,5492,74,297
가구단지사거리,37456,3910,2161,3858,2161,52,195
가구전시장,42072,467,607,460,607,7,34
가구전시장,42074,762,659,758,659,4,45
가나안마을앞,43904,17,15,17,15,0,1
가나안마을앞,43905,25,6,25,6,0,1
가능포,43969,4,3,2,3,2,0
가능포,43970,0,46,0,46,0,1
가림고등학교,42078,14418,13587,14111,13587,307,903
가야,42807,793,3,767,3,26,25
가야,42808,50,1545,43,1545,7,51
가양역.우성아파트,25107,9581,6874,9516,6874,65,530
가오대입구,80033,250,396,222,396,28,20
가오대입구,80034,113,588,90,588,23,22
가원초등학교,42952,7020,4736,6924,4736,96,379
가원초등학교,89118,2724,5973,2651,5973,73,280
가재우물터,35678,5,5,5,5,0,0
가재우물터,35700,3,12,3,12,0,0
가재울사거리,42039,2476,5582,2458,5582,18,259
가재울사거리,42042,8173,5204,8089,5204,84,431
가재울역,42034,2388,2864,2374,2864,14,169
가재울역,42035,3855,2195,3784,2195,71,195
가정(루원시티)역,89050,5027,46884,4971,46884,56,1674
가정(루원시티)역,89051,62682,6893,62447,6893,235,2244
가정(루원시티)역,89075,78092,78552,77613,78552,479,5053
가정(루원시티)역,89078,89592,76497,88992,76497,600,5357
가정3동성당,42226,546,3487,523,3487,23,130
가정LH3단지정문앞,89041,18674,3840,18483,3840,191,726
가정고등학교,42200,11733,4781,11504,4781,229,532
가정고등학교,42203,3519,7619,3433,7619,86,359
가정교차로,89390,128,704,91,704,37,26
가정교차로,89391,526,3563,512,3563,14,131
가정동성당,89102,3655,3482,3514,3482,141,230
가정동성당,89105,2904,1886,2839,1886,65,154
가정보금자리,89119,1502,396,1492,396,10,61
가정보금자리,89120,15,1591,14,1591,1,51
가정여자중학교,42041,445,7487,433,7487,12,255
가정여중입구,89303,896,853,886,853,10,56
가정중앙시장역,42215,1388,1075,1363,1075,25,79
가정중앙시장역,42219,1130,1928,1112,1928,18,98
가정택지삼거리,89385,306,207,304,207,2,16
가정택지삼거리,89386,228,450,225,450,3,21
가정휴먼시아3단지,89186,1140,1453,1128,1453,12,83
가정휴먼시아3단지,89187,1702,1743,1662,1743,40,111
가좌2동행정복지센터,42073,5915,272,5855,272,60,199
가좌2동행정복지센터,42076,164,5255,147,5255,17,174
가좌3동행정복지센터,42075,13833,14439,13638,14439,195,912
가좌4동행정복지센터,42062,5100,7455,5003,7455,97,405
가좌고등학교,42060,16180,12378,15817,12378,363,921
가좌고등학교,42061,5870,8833,5678,8833,192,474
가좌공단,42526,76,11189,47,11189,29,363
가좌공단,42945,8414,15,8348,15,66,271
가좌교회,42055,3832,8871,3731,8871,101,409
가좌교회,42057,4397,3909,4324,3909,73,267
가좌녹지공원,42029,1260,3582,1253,3582,7,156
가좌녹지공원,42030,1778,985,1768,985,10,89
가좌농협,42066,8411,7599,8234,7599,177,516
가좌농협,42067,6146,5780,5945,5780,201,384
가좌동차고,42939,2864,347,2157,347,707,103
가좌동차고지,42522,666,1119,29,1119,637,57
가좌두산위브104동앞,42090,5642,3847,5551,3847,91,306
가좌사거리,42043,35,315,26,315,9,11
가좌사거리,42044,513,4573,493,4573,20,164
가좌진주아파트,42100,14453,30489,14222,30489,231,1449
가좌체육공원,42058,7751,1008,7662,1008,89,282
가좌초등학교,42069,4326,5151,4246,5151,80,305
가좌초등학교,42070,5252,2701,5136,2701,116,256
가좌테니스장,37454,2402,1044,2388,1044,14,111
가좌테니스장,37457,875,1550,868,1550,7,78
가좌현대아파트,42130,8873,2621,8620,2621,253,370
가좌현대아파트,42133,918,9061,900,9061,18,321
가좌홈플러스(쌍마아파트),42101,11042,8308,10655,8308,387,624
가좌홈플러스(쌍마아파트),42103,7951,11890,7674,11890,277,640
가좌환경사업소,42631,7674,3921,7612,3921,62,374
가좌환경사업소 북측,89341,224,408,218,408,6,20
가좌환경사업소북측,89342,20,215,20,215,0,7
가천대학교,38270,1340,987,1264,987,76,75
가천대학교,38284,8673,2703,8452,2703,221,366
가천대학교(노인복지회관),38269,960,998,939,998,21,63
가천의대,43237,20,54,20,54,0,2
가천의대,43897,24,5,20,5,4,0
가톨릭대,43156,0,1,0,1,0,0
가톨릭대,43325,4,61,4,61,0,2
가현오일뱅크,42734,40,14,39,14,1,1
가현중학교,42722,3319,3269,3250,3269,69,212
가현초교앞(루에블리아파트),89242,3818,4654,3620,4654,198,273
가현초교앞(센트럴타운아파트),89243,6048,1839,5932,1839,116,254
각곡,43602,2,96,2,96,0,3
각곡,43772,208,6,187,6,21,6
간석4거리,39538,309,301,291,301,18,19
간석4동새마을금고,39343,3366,6418,3248,6418,118,315
간석4동새마을금고,39346,3472,2765,3381,2765,91,201
간석4동행정복지센터,39403,4540,8746,4504,8746,36,428
간석4동행정복지센터,39412,5434,3182,5381,3182,53,277
간석금호어울림아파트,39334,28473,13754,27877,13754,596,1362
간석남부역,37429,3637,733,3544,733,93,140
간석남부역,37435,8228,2807,8050,2807,178,355
간석남부역,37529,1299,3167,1253,3167,46,144
간석동용광경로당,39394,1008,559,989,559,19,50
간석래미안.자이,39333,17612,20228,17418,20228,194,1220
간석북부역,39806,3612,70,3514,70,98,118
간석북부역,39807,110,2322,79,2322,31,78
간석북부역·우성1차,39368,12742,4557,12722,4557,20,558
간석북부역·우성1차,39370,5020,10059,4989,10059,31,486
간석사거리,39413,14324,9180,14095,9180,229,758
간석사거리,39414,4684,10099,4606,10099,78,476
간석사거리,39430,2106,2603,2071,2603,35,151
간석사거리(상인천중학교),39422,13244,30527,13037,30527,207,1411
간석사거리(상인천중학교),39426,34520,19625,34142,19625,378,1746
간석시장,39434,14022,33684,13757,33684,265,1538
간석시장,39436,61055,34549,60349,34549,706,3084
간석시장,39437,16309,22251,16059,22251,250,1243
간석오거리,39460,19509,15000,19079,15000,430,1113
간석오거리,39597,4969,4253,4944,4253,25,297
간석오거리(교원공제조합),39444,38594,30997,38179,30997,415,2244
간석오거리(인천웨딩홀),39406,8951,12388,8646,12388,305,688
간석오거리(인천웨딩홀),39423,36383,21717,35900,21717,483,1874
간석오거리역(7번출구),39447,17773,32240,17623,32240,150,1613
간석오거리역(8번출구),39449,62972,76078,62738,76078,234,4485
간석지구대,39535,552,774,540,774,12,42
간석지구대,39536,542,652,530,652,12,38
간석풍림아파트,92053,424,568,416,568,8,32
간석한신더휴아파트맞은편,37447,2211,489,2185,489,26,87
간재울초등학교,42347,6161,4039,5944,4039,217,329
간촌,43504,43,88,42,88,1,4
간촌,43518,83,32,80,32,3,3
갈산대동아파트,40550,271,772,264,772,7,33
갈산동아아파트,40567,1580,1620,1552,1620,28,103
갈산동입구,40622,60,5136,60,5136,0,167
갈산동천주교회,40652,896,4932,853,4932,43,188
갈산동천주교회맞은편,40650,5556,4764,5472,4764,84,332
갈산두산아파트,40544,4190,6061,4070,6061,120,330
갈산사거리,40631,2838,4330,2736,4330,102,231
갈산사거리,40634,3243,5051,3164,5051,79,267
갈산새마을금고,40635,9163,2056,8997,2056,166,361
갈산시장,40628,6947,6185,6814,6185,133,423
갈산시장.갈산도서관,40629,2431,7063,2357,7063,74,306
갈산역,40601,37628,12813,37411,12813,217,1627
갈산역,40602,11024,45952,10864,45952,160,1837
갈산역(1번출구),40604,26292,7342,26076,7342,216,1084
갈산역(부평4공단)4번출구,40606,6655,19537,6585,19537,70,844
갈산주공1단지,40578,3124,2072,3037,2072,87,167
갈산주공1단지105동,40813,7622,3292,7496,3292,126,352
갈산주공2단지,40562,297,1101,289,1101,8,45
갈산주공2단지,40577,4359,7845,4217,7845,142,393
갈산태화아파트,40542,454,1258,444,1258,10,55
갈산태화아파트,40664,5089,800,5015,800,74,189
갈산태화아파트,40666,274,1572,267,1572,7,59
갈산태화아파트,40667,626,2575,616,2575,10,103
갈월초등학교,40531,100,1188,96,1188,4,41
갈현경로당,41491,78,306,78,306,0,12
갈현경로당앞,41607,196,49,190,49,6,7
갈현교,41608,171,4,150,4,21,5
갈현교,41609,94,177,1,177,93,8
갈현교입구,41492,568,29,547,29,21,19
갈현교입구,41617,0,251,0,251,0,8
갈현동마을,41351,903,730,881,730,22,52
갈현동마을,41352,338,1695,336,1695,2,65
갑곶돈대.강화전쟁박물관,43365,13,6,12,6,1,0
갑곶돈대.강화전쟁박물관,43728,8,33,8,33,0,1
갑곶돈대입구,43367,8,10,7,10,1,0
갑곶돈대입구,43726,8,18,8,18,0,0
갑륭초교,43724,5,107,5,107,0,3
갑문,35125,38,700,34,700,4,23
갑문,35504,171,11,162,11,9,5
강남시장,42172,22500,14228,21907,14228,593,1184
강남시장,42173,13390,12278,13111,12278,279,828
강남역.역삼세무서,23287,1059,1379,1059,1379,0,78
강남역도시에빛,31076,2788,9201,2788,9201,0,386
강남역서초현대타워앞,31016,56868,35551,56790,35551,78,2981
강남중교,43213,72,19,72,19,0,2
강남중교,43278,7,251,7,251,0,8
강서중학교,43660,2,98,2,98,0,3
강서중학교,43898,174,7,164,7,10,5
강인여객,40020,1128,1541,1076,1541,52,86
강인여객,40022,1213,887,1202,887,11,67
강화경찰서,43209,262,64,240,64,22,10
강화경찰서,43624,2,235,1,235,1,7
강화고등학교,43564,5,22,5,22,0,0
강화고등학교,43761,112,132,107,132,5,7
강화군 행복센터,43055,88,1910,86,1910,2,64
강화군 행복센터,43056,3,210,3,210,0,6
강화군노인문화센터,90373,0,33,0,33,0,1
강화군노인문화센터,90374,24,2,24,2,0,0
강화군청,43065,3846,661,3608,661,238,145
강화군청,43108,823,2913,797,2913,26,120
강화루지.강남상회,43150,167,74,167,74,0,7
강화루지.강남상회,43250,133,233,131,233,2,11
강화마니산,43001,42,70,41,70,1,3
강화마니산,43002,548,148,516,148,32,22
강화문화원.종합전시관,43097,0,40,0,40,0,1
강화문화원.종합전시관,43098,41,558,38,558,3,19
강화병원,43088,37,1281,28,1281,9,42
강화병원,43089,968,52,960,52,8,32
강화산단,90123,0,10,0,10,0,0
강화산단입구,90096,0,1,0,1,0,0
강화산단입구,90097,16,0,16,0,0,0
강화산성서문,43080,1,13,1,13,0,0
강화산성서문,43081,22,49,22,49,0,2
강화서문,43063,506,456,496,456,10,31
강화서문,43064,441,372,398,372,43,26
강화수양관앞,43467,41,34,40,34,1,2
강화수양관앞,43732,1,11,1,11,0,0
강화슈퍼,43066,656,1290,631,1290,25,62
강화슈퍼,43068,1975,298,1783,298,192,73
강화실버케어스앞,43975,49,194,49,194,0,7
강화실버케어스앞,43976,94,82,94,82,0,5
강화아시아드BMX경기장,43799,1,85,0,85,1,2
강화여자중학교,90334,0,58,0,58,0,1
강화역사박물관(고인돌),43601,372,35,357,35,15,13
강화역사박물관(고인돌),43670,35,386,32,386,3,13
강화장례식장,43918,1539,86,1463,86,76,52
강화장례식장,43946,49,1810,30,1810,19,59
강화중학교,43207,37,30,36,30,1,2
강화중학교,43623,9,36,9,36,0,1
강화터미널,43058,0,2,0,2,0,0
강화터미널,43096,51946,1093,48839,1093,3107,1710
개항동 어울터,35197,9692,1969,9302,1969,390,376
개항동 어울터,35198,2571,9100,2510,9100,61,376
개화2치안센터,25023,65,2110,65,2110,0,70
개화2치안센터,25024,3113,61,3094,61,19,102
개화역1번출구.개화검문소,25030,219,8487,219,8487,0,280
개화역1번출구.개화검문소,25031,3210,313,3181,313,29,113
개화역광역환승센터,25182,1624,2340,1623,2340,1,127
갤러리84입구,35666,62,34,62,34,0,3
갤러리84입구,35667,18,46,18,46,0,2
갯벌슈퍼,43410,6,19,6,19,0,0
갯벌슈퍼,43513,9,6,7,6,2,0
거북시장,42132,15490,13102,14953,13102,537,922
거북시장,42136,14316,12255,14006,12255,310,857
거산정공.(주)록키,39137,1352,1778,1350,1778,2,100
거잠포선착장,35302,392,2732,389,2732,3,100
거잠포선착장,35303,1385,164,1380,164,5,49
거잠포회센터,35588,118,20,70,20,48,4
건설기술교육원,39353,7472,12483,7405,12483,67,643
건설기술교육원,39354,5741,4422,5707,4422,34,327
건영아파트,38069,16873,40977,16652,40977,221,1866
건일아파트,43015,484,191,475,191,9,21
건일아파트,43094,194,297,182,297,12,15
건지사거리,42882,103,1,103,1,0,3
건지사거리,42883,1,278,1,278,0,9
건평,43168,89,90,89,90,0,5
건평,43186,12,54,12,54,0,2
건평리,43187,51,27,49,27,2,2
건평리,43651,7,60,7,60,0,2
건평마을회관,43594,18,52,18,52,0,2
건평입구,43170,5,14,5,14,0,0
건평입구,43331,19,10,19,10,0,0
걸포북변역,35560,42,3244,42,3244,0,106
걸포북변역,35610,2656,137,2613,137,43,90
걸포사거리.우리병원,35561,235,350,232,350,3,18
검단1차피오레·금호어울림아파트,89457,2,13,2,13,0,0
검단1차피오레·금호어울림아파트,89458,2,46,2,46,0,1
검단LH행복주택,89408,7954,2427,7877,2427,77,334
검단공구상가,89053,83,498,76,498,7,18
검단공구상가,89065,289,213,274,213,15,16
검단노인복지관,42695,160,354,138,354,22,16
검단농기구센터,89316,127,21,127,21,0,4
검단농기구센터,89324,1,166,1,166,0,5
검단농협,42432,26031,9558,25381,9558,650,1148
검단농협,42434,4968,14550,4814,14550,154,629
검단동행정복지센터(검단고교),42441,3620,8085,3410,8085,210,377
검단동행정복지센터(검단고교),42445,4268,4846,4154,4846,114,294
검단로지스틱스파크,41339,1128,225,1126,225,2,43
검단로지스틱스파크,42395,203,1349,198,1349,5,50
검단메가박스,42383,2338,1694,2283,1694,55,130
검단메가박스,42384,1009,2474,965,2474,44,112
검단모아엘가그랑데아파트,42483,55,483,52,483,3,17
검단사거리역,42419,13830,16103,13532,16103,298,965
검단사거리역,42426,2346,8982,2322,8982,24,365
검단사거리역,42427,7802,3389,7744,3389,58,361
검단사거리역,42537,10687,11694,10421,11694,266,721
검단신도시예미지더시그너스,89415,426,320,425,320,1,24
검단신도시예미지더시그너스,89416,2,342,2,342,0,11
검단신도시우미린리버포레,89409,3639,7408,3603,7408,36,356
검단오류공단,42702,14,509,8,509,6,16
검단오류공단,42703,382,13,373,13,9,12
검단오류역,89057,6785,627,6714,627,71,239
검단오류역,89060,659,6615,637,6615,22,234
검단오류역우방아이유쉘,89067,298,747,298,747,0,33
검단오류역우방아이유쉘,89068,938,133,898,133,40,34
검단오류풍림아이원,89251,97,319,85,319,12,13
검단오류풍림아이원,89252,370,176,358,176,12,17
검단우방아이유쉘아파트,42688,360,397,330,397,30,24
검단원흥아파트,42400,1856,1143,1815,1143,41,96
검단원흥아파트,42401,1414,3285,1373,3285,41,151
검단지식산업센타,89054,9028,123,8814,123,214,295
검단지식산업센타,89063,154,6660,143,6660,11,219
검단초등학교,42475,8295,3832,8090,3832,205,391
검단초등학교,42482,3667,5524,3583,5524,84,296
검단초등학교,89332,49,124,48,124,1,5
검단초등학교,89333,152,84,144,84,8,7
검단출장소,42423,17321,11088,16928,11088,393,916
검단출장소,42424,4519,11100,4392,11100,127,503
검단탑종합병원,42877,440,603,417,603,23,33
검단하나아파트,42421,2486,539,2450,539,36,97
검단하나아파트,42422,491,410,480,410,11,29
검단힐스테이트5차아파트,42557,3,162,3,162,0,5
검단힐스테이트5차아파트,42558,166,655,154,655,12,26
검문소,43662,2,6,2,6,0,0
검문소,43812,77,138,71,138,6,6
검문소,90042,3,8,2,8,1,0
검문소,90043,25,128,23,128,2,4
검바위역,42348,4532,978,4437,978,95,177
검바위역,42349,1462,3255,1429,3255,33,152
검암경서동행정복지센터,42352,1961,6353,1865,6353,96,268
검암경서동행정복지센터,42353,6600,1963,6330,1963,270,276
검암사거리,42356,2232,3207,2165,3207,67,175
검암사거리,42357,4542,1711,4405,1711,137,201
검암사거리,42358,4724,1526,4632,1526,92,201
검암역(시내방면),42364,20810,2618,20594,2618,216,755
검암역(원당방면),42363,1586,27284,1558,27284,28,931
검암역.서해그랑블아파트,42360,4897,4586,4840,4586,57,305
검암역로열파크씨티푸르지오1단지,89167,1096,6,1029,6,67,35
검암역로열파크씨티푸르지오1단지,89168,17,652,4,652,13,21
검암역로열파크씨티푸르지오2단지,89169,474,9,473,9,1,15
검암역로열파크씨티푸르지오2단지,89170,13,723,2,723,11,23
검암역입구,42851,10386,6005,10321,6005,65,528
검암역입구,42852,6429,6485,6383,6485,46,416
검암역입구(시천교밑),89250,10488,2725,10465,2725,23,426
검암중학교,42359,3601,1582,3486,1582,115,167
검암중학교,42362,2723,3000,2689,3000,34,184
검암초등학교,42361,437,6381,417,6381,20,219
경기국제통상고.포도마을뉴서울.중앙공원,55042,541,2094,510,2094,31,85
경기국제통상고.포도마을뉴서울.중앙공원,55043,1852,921,1773,921,79,89
경기도교육청학생교육원,43162,2,120,2,120,0,3
경기도교육청학생교육원,43222,173,36,172,36,1,6
경기주유소,43051,120,420,111,420,9,17
경남1차,40343,9645,404,9394,404,251,324
경남1차아파트,40376,15336,7003,15177,7003,159,720
경남2차,40305,9097,64,8973,64,124,295
경남아너스빌,42099,3540,1440,3415,1440,125,160
경남아너스빌,42102,1362,2985,1290,2985,72,140
경남아너스빌아파트,42110,4681,3252,4595,3252,86,255
경남아너스빌아파트,42111,1954,2716,1915,2716,39,150
경남아파트,35143,8147,3121,8010,3121,137,363
경남아파트,35147,570,2277,543,2277,27,91
경남아파트,38281,8978,7337,8751,7337,227,526
경남아파트,41011,16724,4402,16326,4402,398,681
경남아파트,41014,4165,8813,4114,8813,51,418
경남아파트,42332,7250,2756,7152,2756,98,322
경남아파트,42334,2688,7894,2658,7894,30,341
경남아파트308동앞,40334,47,7446,44,7446,3,241
경남아파트311동앞,40300,18,5822,17,5822,1,188
경남아파트313동앞,40287,19,6573,16,6573,3,212
경동택배,89315,58,4,58,4,0,2
경동택배,89325,0,36,0,36,0,1
경명초등학교,89216,1442,559,1441,559,1,64
경명초등학교,89277,4660,8029,4606,8029,54,409
경명초등학교,89278,4677,5796,4636,5796,41,337
경방신약,39136,5605,1619,5592,1619,13,233
경방신약,39138,2716,9217,2695,9217,21,384
경복예식장,39399,10635,4896,10347,4896,288,501
경서농원,42333,198,494,194,494,4,22
경서농원,42335,102,1135,84,1135,18,39
경서지구입구,42303,897,5720,886,5720,11,213
경서지구입구,42671,2549,2727,2511,2727,38,170
경서지구입구,42672,4202,2669,4128,2669,74,221
경서초등학교,42569,4693,2132,4640,2132,53,220
경서초등학교,42570,2547,2571,2510,2571,37,165
경신마을,39646,186,184,180,184,6,11
경신마을,39982,205,1147,197,1147,8,43
경신아파트,41216,2012,1178,1983,1178,29,102
경신아파트,41223,1950,3511,1896,3511,54,176
경연초중학교,89271,7159,4902,6986,4902,173,389
경연초중학교,89272,4011,5757,3983,5757,28,315
경연초중학교·청라센텀로제비앙,89286,2040,960,1981,960,59,96
경연초중학교·호반베르디움6차,89285,1801,1694,1745,1694,56,112
경인계량소,42549,1206,7,1181,7,25,39
경인계량소,42550,6,819,5,819,1,26
경인교대.부평향교,41138,873,1210,831,1210,42,67
경인교대.부평향교,41139,1084,1000,1071,1000,13,67
경인교대역입구,41428,10204,7737,9960,7737,244,578
경인교대역입구,41429,8747,9626,8575,9626,172,592
경인교회앞,40077,1066,3758,1009,3758,57,155
경인방송,37003,116,124,114,124,2,7
경인방송,37004,78,249,73,249,5,10
경인산업,39688,801,1512,790,1512,11,74
경인아라뱃길여객터미널,42869,510,12,506,12,4,16
경인여대,41277,9213,15408,9189,15408,24,794
경인여대,41278,5787,6674,5765,6674,22,401
경인특장,42547,309,3,285,3,24,10
경인항다목적부두,89151,134,4,134,4,0,4
경인항다목적부두,89152,3,144,3,144,0,4
경전말,43934,21,1,11,1,10,0
경제자유구역청,38514,2201,2068,2162,2068,39,137
경제자유구역청,38515,3012,3602,2977,3602,35,213
경진브로아,39042,1028,1106,995,1106,33,68
경흥빌라,43372,467,9,437,9,30,15
경흥빌라,43616,20,176,17,176,3,6
경희유치원앞,39991,165,612,153,612,12,25
경희유치원앞,39992,161,235,161,235,0,12
계량소,40195,2136,271,2078,271,58,77
계룡리슈빌,55225,7603,2222,7596,2222,7,316
계산3동행정복지센터,41649,68,34,68,34,0,3
계산3동행정복지센터,41656,155,121,152,121,3,8
계산공고,41167,3819,3472,3746,3472,73,235
계산공고,41170,5572,9041,5453,9041,119,471
계산공고앞,41169,2910,2158,2815,2158,95,163
계산국민체육센터,41276,1931,3143,1892,3143,39,163
계산국민체육센터,41613,1677,2107,1662,2107,15,122
계산동수협,41533,4518,5162,4430,5162,88,312
계산동아아파트,41231,251,25,242,25,9,8
계산동우체국,41427,6580,4056,6508,4056,72,343
계산삼거리,41196,399,241,388,241,11,20
계산삼거리(신도브래뉴),41199,11043,11005,10895,11005,148,711
계산삼거리(신도브래뉴),41201,4730,8899,4643,8899,87,439
계산시장,41176,4190,4958,4101,4958,89,295
계산여고,41576,887,841,840,841,47,55
계산여자고등학교,41221,32,233,32,233,0,8
계산여자고등학교,41224,1243,1066,1203,1066,40,74
계산역,41247,6471,5584,6430,5584,41,388
계산역,41371,15088,78,15008,78,80,489
계산역,41426,29526,24363,29332,24363,194,1738
계산역,41431,26575,32113,26234,32113,341,1893
계산우체국,41430,11419,12024,11280,12024,139,756
계산전통시장,41648,73,16,70,16,3,2
계산전통시장,41657,25,214,21,214,4,7
계산주공아파트,41423,13139,14454,12881,14454,258,890
계산중학교,41577,326,38,320,38,6,11
계산현대아파트,41650,10,27,10,27,0,1
계양1동주민자치센터,41476,7844,1256,7723,1256,121,293
계양1동주민자치센터,41520,420,8137,372,8137,48,276
계양3동행정복지센터,41525,566,921,561,921,5,47
계양3동행정복지센터,41526,944,561,939,561,5,48
계양CGV,41140,3706,3555,3629,3555,77,234
계양경찰서,41184,10433,7611,10349,7611,84,582
계양경찰서,41185,6049,9081,5982,9081,67,488
계양경찰서,41195,20378,5911,19943,5911,435,848
계양경찰서·계양구청,41194,4561,17105,4499,17105,62,698
계양구의회,41123,6052,5199,5963,5199,89,362
계양구의회,41124,5762,6144,5580,6144,182,384
계양구청,41177,4763,4373,4749,4373,14,294
계양구청,41180,8140,9685,7945,9685,195,575
계양구청,41188,4038,1881,3936,1881,102,190
계양구청,41197,47,2451,45,2451,2,80
계양구청앞,41204,8318,3806,8137,3806,181,391
계양국제어학관,41651,10,44,10,44,0,1
계양도서관,41251,6500,10746,6396,10746,104,556
계양문화회관,41248,2030,1633,1998,1633,32,118
계양문화회관,41255,2894,4487,2858,4487,36,238
계양산성박물관,41285,1470,1904,1431,1904,39,108
계양산성박물관,41286,951,2309,942,2309,9,105
계양산장미원 입구(계산동자연풀장),41186,969,773,966,773,3,56
계양산장미원 입구(계산동자연풀장),41189,580,1602,563,1602,17,70
계양산전통시장,41297,673,4827,658,4827,15,177
계양산전통시장,41298,5090,1287,4883,1287,207,205
계양산전통시장,41306,20309,18918,19945,18918,364,1265
계양산지구대,41281,921,1438,909,1438,12,76
계양산지구대,41282,826,1231,787,1231,39,66
계양새마을금고,41094,1390,1598,1353,1598,37,96
계양새마을금고,41097,1649,2106,1598,2106,51,121
계양세무서,41054,1337,1185,1316,1185,21,81
계양세무서,41058,765,1278,752,1278,13,65
계양센트레빌1단지,41550,5887,5639,5749,5639,138,371
계양센트레빌1단지,41627,1060,646,1054,646,6,55
계양센트레빌1단지,41628,195,751,194,751,1,30
계양센트레빌1단지(111동앞),41551,7394,6058,7335,6058,59,433
계양센트레빌2단지,41625,228,827,224,827,4,34
계양여성회관,41404,3547,4433,3495,4433,52,257
계양역,41357,108704,57161,108324,57161,380,5350
계양역,41358,64314,93773,64059,93773,255,5099
계양역(귤현역방면),41659,4543,51,4514,51,29,148
계양임광그대가아파트,41118,3605,160,3440,160,165,121
계양종합사회복지관,41120,609,1521,605,1521,4,68
계양종합사회복지관,41121,1788,755,1735,755,53,82
계양중학교,41340,2884,1185,2785,1185,99,131
계양중학교,41341,1708,7765,1670,7765,38,305
계양체육관(아시아드양궁장),41454,528,971,525,971,3,48
계양체육관(아시아드양궁장),41455,1761,801,1741,801,20,82
계양체육관(아시아드양궁장),41567,2572,613,2560,613,12,102
계양체육관(아시아드양궁장),41568,577,4738,570,4738,7,171
계양체육관(효성해링턴플레이스),41440,4181,813,4162,813,19,161
계양체육관.대동아파트,41173,49,1661,37,1661,12,55
고구1리입구,90006,72,6,67,6,5,2
고구1리입구,90007,3,53,3,53,0,1
고구2리마을회관입구,90014,1,108,1,108,0,3
고구2리마을회관입구,90015,128,3,117,3,11,4
고구저수지,90008,25,19,24,19,1,1
고구저수지,90009,17,25,16,25,1,1
고구촌,90012,0,55,0,55,0,1
고구촌,90013,78,3,75,3,3,2
고능2리 종점,90372,13,4,8,4,5,0
고능2리능촌마을회관,90371,0,9,0,9,0,0
고능리공소,90208,113,97,95,97,18,6
고능리입구,43291,19,54,16,54,3,2
고능리입구,43534,62,1,62,1,0,2
고다니마을9단지,80362,109,51,107,51,2,5
고려산업,39486,957,1413,945,1413,12,76
고려양행,39111,1030,1692,1011,1692,19,87
고려저수지입구,43249,40,78,40,78,0,3
고려저수지입구,43486,53,31,51,31,2,2
고비고개정상,43569,10,0,10,0,0,0
고비고개정상,43844,0,16,0,16,0,0
고산마을입구,90016,5,82,4,82,1,2
고산마을입구,90017,55,4,52,4,3,1
고산촌,43544,132,45,116,45,16,5
고산촌,43779,39,92,35,92,4,4
고상골,43269,3,65,1,65,2,2
고상골,43382,45,13,44,13,1,1
고상골입구,43266,133,11,111,11,22,4
고상골입구,43552,8,86,7,86,1,3
고속터미널,31017,16530,301,16489,301,41,542
고속터미널,31018,625,25562,622,25562,3,844
고시기(가재골),43770,14,1,9,1,5,0
고시기(가재골),90126,0,1,0,1,0,0
고염나무골,35473,21,127,21,127,0,4
고염나무골,35474,164,15,161,15,3,5
고인돌입구,43550,1,30,1,30,0,1
고인돌체육관(태권도경기장),43383,9,6,8,6,1,0
고인돌체육관앞,90045,87,461,85,461,2,17
고인돌체육관앞,90046,560,136,545,136,15,22
고잔고등학교,39691,292,2662,276,2662,16,95
고잔마을,43284,64,0,58,0,6,2
고잔마을,43532,2,47,2,47,0,1
고창마을.KCC,80328,228,160,228,160,0,12
고창촌,43076,41,88,38,88,3,4
고창촌입구,43166,21,5,19,5,2,0
고창촌입구,43345,3,15,3,15,0,0
고천3리마을회관,43341,109,3,101,3,8,3
고천3리마을회관,43574,1,59,1,59,0,1
고천5리마을회관,90341,17,0,14,0,3,0
고천5리마을회관,90345,1,18,1,18,0,0
고천교,43339,14,26,12,26,2,1
고천교,43849,32,2,20,2,12,1
고촌역,80061,4598,512,4594,512,4,164
고촌역,80062,453,7929,453,7929,0,270
고합아파트,70036,164,112,147,112,17,8
고향산천,43464,18,12,18,12,0,0
고향산천,43610,21,24,18,24,3,1
곡촌,43427,23,18,22,18,1,1
곡촌,43457,80,8,70,8,10,2
곡촌,43789,52,30,52,30,0,2
곡촌,43816,5,86,4,86,1,2
곤능,43197,11,82,10,82,1,3
곤능,43319,32,7,27,7,5,1
골드클래스,42936,284,907,198,907,86,38
공개마을,90195,14,0,14,0,0,0
공개마을,90196,1,16,1,16,0,0
공구상가,36092,400,1602,382,1602,18,64
공구상가.간동입구,80021,1039,112,1018,112,21,37
공군8547부대앞,35718,10,46,10,46,0,1
공군8547부대앞,35719,6,136,6,136,0,4
공단공구상가,92048,0,19,0,19,0,0
공단공원앞,42739,196,241,196,241,0,14
공단공원앞,42740,208,56,207,56,1,8
공단본부,42270,363,942,360,942,3,42
공단본부,42756,3290,1023,3269,1023,21,139
공단본부,42757,1026,2516,1019,2516,7,114
공단사거리,42995,5,930,5,930,0,30
공단사거리,42996,1262,10,1186,10,76,41
공단사거리,89069,3,400,3,400,0,13
공단사거리,89070,506,529,480,529,26,33
공단소방서,39062,1352,3575,1343,3575,9,158
공단시장,37426,3173,5980,3101,5980,72,295
공단시장,37427,7881,3359,7810,3359,71,362
공단오거리,40565,1641,590,1626,590,15,71
공단오거리,40566,430,2704,428,2704,2,101
공단유통상가,42940,54,1210,44,1210,10,40
공단유통상가,42941,1335,36,1232,36,103,44
공단자동차,42022,1664,2112,1637,2112,27,121
공단치안센터,37444,1569,881,1549,881,20,79
공단치안센터,37445,345,1717,344,1717,1,66
공단회관,39119,1414,4035,1399,4035,15,175
공단회관,39123,3294,1073,3276,1073,18,140
공설운동장,43091,47,385,47,385,0,13
공설운동장,43092,233,190,219,190,14,13
공숙입구,43290,4,89,4,89,0,3
공숙입구,43490,22,50,21,50,1,2
공영산업,89148,16,630,16,630,0,20
공작아파트,39479,2105,3716,2022,3716,83,187
공작아파트,39480,3105,4861,3069,4861,36,256
공장단지입구,42555,186,152,176,152,10,10
공촌마을,42323,4839,3152,4722,3152,117,257
공촌마을,42598,2432,4357,2363,4357,69,219
공촌사거리,42324,16338,10341,16299,10341,39,860
공촌사거리,42330,14519,14383,14399,14383,120,932
공촌사거리,42331,677,573,671,573,6,40
공촌사거리(한국아파트),42322,5179,5165,5124,5165,55,333
공촌정수장,42340,187,105,177,105,10,9
공촌정수장,42341,63,259,63,259,0,10
공항고등학교,35116,2879,465,2638,465,241,107
공항고속도로진입(미정차),35644,1,0,1,0,0,0
공항교회앞,35123,1159,1950,1145,1950,14,100
공항신도시(메디컬사거리),35258,574,1863,559,1863,15,78
공항중학교,35117,761,1950,741,1950,20,87
공항초등학교,35087,105,456,103,456,2,18
공항회센터,35745,55,6,52,6,3,1
관곡마을,90104,0,8,0,8,0,0
관곡마을,90105,18,0,18,0,0,0
관광밸트입구,43874,0,2,0,2,0,0
관광밸트입구,43875,0,4,0,4,0,0
관교여자중학교,37226,9184,8444,8993,8444,191,568
관교여자중학교,37229,2316,2558,2273,2558,43,157
관교여자중학교,37231,3318,4048,3200,4048,118,237
관교중학교,37200,214,1023,212,1023,2,39
관교중학교(약수터),37202,4956,8058,4843,8058,113,419
관교중학교(약수터),37203,10914,6531,10666,6531,248,562
관리공단본부,42720,722,105,716,105,6,26
관창마을,35252,1510,924,1441,924,69,78
관창마을,35253,1853,2014,1816,2014,37,124
광명아파트,37434,14514,6852,14413,6852,101,689
광명아파트,39348,7593,14465,7534,14465,59,711
광명아파트,39835,15,895,9,895,6,29
광명아파트,40590,2788,967,2712,967,76,121
광명아파트,40817,7658,1510,7524,1510,134,295
광명아파트,41096,550,2466,519,2466,31,97
광명아파트,41098,2595,788,2546,788,49,109
광명아파트,41108,15610,21797,15416,21797,194,1206
광명아파트,41448,2658,8266,2540,8266,118,352
광명역IC진입(미정차),53043,1,0,1,0,0,0
광명역IC출입(미정차),53042,12,0,12,0,0,0
광명항,35708,143,2,140,2,3,4
광명항,35714,1956,1759,1950,1759,6,119
광명항(샘꾸미),35730,20,5,20,5,0,0
광성보,43674,37,108,37,108,0,4
광성오리,43128,11,4,11,4,0,0
광성오리,43862,10,32,10,32,0,1
광일아파트,40855,3605,1153,3522,1153,83,153
광일아파트,40874,1760,3218,1720,3218,40,160
교대역,31013,27255,26456,27222,26456,33,1732
교대입구,41141,2102,3015,2070,3015,32,165
교대입구,41142,3002,2351,2897,2351,105,172
교대후문,41362,1264,249,1255,249,9,48
교대후문,41363,239,2703,230,2703,9,94
교동중고후문,90024,12,108,10,108,2,3
교동중고후문,90025,156,10,139,10,17,5
교보생명,37357,21621,82949,21361,82949,260,3373
교산교회,43496,53,15,48,15,5,2
교산교회,43719,24,26,21,26,3,1
교산리입구,43694,35,30,23,30,12,2
교산리입구,43748,18,36,15,36,3,1
교산상회앞,43494,4,3,2,3,2,0
교산상회앞,43715,5,1,5,1,0,0
교육개발원입구,31005,1028,10,1028,10,0,33
교육개발원입구,31006,36,1046,36,1046,0,34
교통방송사거리,37538,815,2362,755,2362,60,102
교통방송사거리,37539,1101,1591,1065,1591,36,86
교통연수원,41191,589,2061,545,2061,44,85
교통연수원,41192,2263,1131,2243,1131,20,109
교회앞,43216,12,4,9,4,3,0
교회앞,43309,24,14,24,14,0,1
교회앞,43430,24,14,21,14,3,1
교회앞,43818,28,30,25,30,3,1
교회앞,90338,1,20,1,20,0,0
교회앞,90348,17,0,16,0,1,0
구검문소,43196,0,78,0,78,0,2
구검문소,43622,114,0,113,0,1,3
구능재,90193,27,8,24,8,3,1
구능재,90194,2,27,2,27,0,0
구도일주유소,40902,113,1390,110,1390,3,48
구두물입구,35219,357,240,357,240,0,19
구래리,80006,283,1559,263,1559,20,59
구래리,80007,1687,414,1659,414,28,67
구래역,80337,8833,15726,8731,15726,102,792
구래역,80338,19328,8797,18835,8797,493,907
구렁목,43950,155,11,142,11,13,5
구렁목,43951,13,118,13,118,0,4
구름다리,35735,8,86,8,86,0,3
구름다리,35736,36,1,36,1,0,1
구반포역.세화고등학교,31031,1681,31,1680,31,1,55
구봉도입구,62035,36,391,35,391,1,13
구봉도입구,62037,388,24,378,24,10,13
구북성초교,43506,2,3,2,3,0,0
구북성초교,43656,5,6,5,6,0,0
구산사거리,40233,716,465,709,465,7,38
구산사거리,40842,470,20582,382,20582,88,679
구산사거리,40843,3735,7293,3547,7293,188,355
구산중학교,40518,752,798,735,798,17,50
구선택초교,43239,5,4,5,4,0,0
구선택초교,43896,3,5,3,5,0,0
구월1동행정복지센터,39967,851,2,849,2,2,27
구월1동행정복지센터,39981,5,451,5,451,0,14
구월2동행정복지센터,39586,4329,361,4309,361,20,151
구월2동행정복지센터,39607,473,3601,470,3601,3,131
구월도매전통시장,39192,18016,15467,17451,15467,565,1080
구월도매전통시장,39193,19561,30026,19261,30026,300,1599
구월동로데오거리,39195,4825,1183,4767,1183,58,193
구월동우체국,39211,4107,13711,4033,13711,74,574
구월동팬더아파트,39237,9242,8888,9058,8888,184,584
구월동팬더아파트,39238,10382,7173,10099,7173,283,566
구월서초등학교,39204,7348,6053,7158,6053,190,432
구월서초등학교,39205,5882,6085,5741,6085,141,386
구월아시아드1단지,39912,508,5,494,5,14,16
구월아시아드1단지,39913,2,109,1,109,1,3
구월아시아드5단지정문,39883,2559,6171,2479,6171,80,281
구월아시아드5단지후문,39881,2303,4382,2235,4382,68,215
구월아시아드6단지,39885,22665,7799,22275,7799,390,982
구월아시아드6단지,39886,7131,15972,7048,15972,83,745
구월아시아드7단지,39892,1405,2063,1380,2063,25,111
구월아시아드8단지,39891,2621,1249,2606,1249,15,124
구월아시아드8단지,39948,42,408,41,408,1,14
구월아시아드8단지,39949,86,219,74,219,12,9
구월아시아드선수촌센트럴자이,39884,3493,2375,3441,2375,52,189
구월아시아드선수촌아파트,39202,1197,959,1188,959,9,69
구월아시아드선수촌아파트,39203,812,2010,786,2010,26,91
구월아시아드은빛호수공원,39914,10736,5543,10446,5543,290,525
구월아시아드은빛호수공원,39915,6786,6393,6610,6393,176,425
구월우체국,39213,10014,7292,9790,7292,224,558
구월중학교,39281,27364,18843,26645,18843,719,1490
구월중학교,39286,19052,29191,18620,29191,432,1556
구월체육공원,39384,3577,4677,3503,4677,74,266
구월초등학교,39832,1994,4104,1926,4104,68,196
구월초등학교,39833,4150,2448,4053,2448,97,212
구월한내들퍼스티지,39882,4096,1781,3993,1781,103,189
구장수파출소,39375,900,695,876,695,24,51
구재이,43282,45,7,40,7,5,1
구재이,43551,1,14,0,14,1,0
구정슈퍼앞,35498,17,38,17,38,0,1
구정슈퍼앞,35587,77,22,64,22,13,3
구정정미소,90284,8,17,8,17,0,0
구정정미소,90306,17,0,17,0,0,0
구중학교앞,44119,1,11,0,11,1,0
구중학교앞,44148,2,0,1,0,1,0
구하1리입구,43259,2,39,2,39,0,1
구하1리입구,43562,110,2,86,2,24,3
구하2리마을회관,43254,110,0,110,0,0,3
구하2리마을회관,43256,60,0,54,0,6,1
구하2리마을회관,43373,1,65,1,65,0,2
구하2리마을회관,43559,2,59,2,59,0,1
국궁장앞,70151,41,230,39,230,2,8
국립생물자원관,89111,219,454,216,454,3,21
국립생물자원관입구,42741,297,461,289,461,8,24
국립인천공항검역소,35430,27,383,7,383,20,13
국립인천공항검역소,35431,148,67,146,67,2,6
국민건강보험 인천부평지사,40620,1336,4866,1290,4866,46,200
국민건강보험 인천부평지사,40621,4213,1657,4123,1657,90,189
국민건강보험남부지사,37274,9262,10426,9045,10426,217,635
국민은행,38148,1968,5257,1920,5257,48,233
국민은행,38149,5175,2313,5037,2313,138,241
국민은행연수중앙지점,38129,6419,4476,6260,4476,159,351
국민은행연수중앙지점,38571,2268,4185,2211,4185,57,208
국제금융단지,89292,7450,6001,7320,6001,130,433
국제금융단지,89293,2979,5138,2971,5138,8,261
국제성모병원,89030,342,1451,326,1451,16,57
국제성모병원,89031,2503,906,2480,906,23,109
국제성모병원(종점),89369,3,112,3,112,0,3
국제업무단지(공항청사),35026,14087,2498,13777,2498,310,535
국제업무지구역,38528,1448,3157,1442,3157,6,148
국제업무지구역5번출구,38619,2366,1893,2350,1893,16,137
국제이노베이션,37573,4,1543,1,1543,3,49
국제이노베이션,37574,1282,12,1279,12,3,41
국제콘크리트,90050,58,27,55,27,3,2
국제콘크리트,90051,31,139,14,139,17,5
국제학교,38457,2357,615,2275,615,82,95
국제학교,38462,1083,2572,1046,2572,37,117
국촌,43251,136,3,116,3,20,4
국촌,43371,0,90,0,90,0,2
국화리야영장앞,43353,46,2,43,2,3,1
국화리야영장앞,43843,2,62,2,62,0,2
국화맨션,43359,0,4,0,4,0,0
국화맨션,43566,43,6,43,6,0,1
국회연수원입구,43919,1,1,1,1,0,0
국회연수원입구,43920,1,37,1,37,0,1
군인아파트,43046,140,44,140,44,0,5
군인아파트,43047,46,150,42,150,4,6
굴다리,37142,8230,91,8129,91,101,268
굴다리오거리,40231,20018,8405,19610,8405,408,916
굴다리오거리,40232,15684,23530,15453,23530,231,1264
굴다리입구,37152,7480,3763,7180,3763,300,362
굴포천,40506,2429,2403,2344,2403,85,155
굴포천,40509,2439,3717,2386,3717,53,198
굴포천역(롯데마트),40814,44631,26324,44237,26324,394,2288
굴포천역(롯데마트),40815,19493,23524,19229,23524,264,1387
굴포천역(부평농협),40507,6594,8634,6547,8634,47,491
굴포천역(부평농협),40508,9875,6447,9686,6447,189,526
굴포천역(신복사거리),40485,4387,19275,4287,19275,100,763
굴포천역(신복사거리),40498,30855,7442,30559,7442,296,1235
굴포천역(욱일아파트),40519,4986,13468,4946,13468,40,595
굴포천역(욱일아파트),40522,7518,3147,7460,3147,58,344
궁골,43346,0,8,0,8,0,0
궁골,43572,11,1,10,1,1,0
궁현사거리,37575,4,951,4,951,0,30
궁현사거리,37576,403,22,398,22,5,13
귀뚜라미보일러,42003,5,211,0,211,5,6
귀뚜라미보일러,42004,270,1,262,1,8,8
귤현감리교회,41385,2095,5511,2036,5511,59,245
귤현감리교회,41386,4791,3381,4706,3381,85,263
귤현동마을입구,41326,612,124,607,124,5,23
귤현동마을입구,41328,94,602,94,602,0,22
귤현아이파크정문,41572,2286,471,2279,471,7,88
귤현역,41331,5996,4809,5969,4809,27,348
귤현역,41332,1769,918,1763,918,6,86
귤현차량기지(센트레빌3단지),41443,3163,849,3142,849,21,129
귤현차량기지(센트레빌3단지),41444,1281,3874,1246,3874,35,166
귤현차량기지(안골공원),41618,1057,1946,1046,1946,11,96
귤현차량기지(안골공원),41619,133,598,123,598,10,23
귤현현대아이파크,41620,706,1912,698,1912,8,84
그린나래지하차도,35648,13,396,11,396,2,13
그린나래지하차도,35649,2179,734,2163,734,16,93
그린빌라,42222,2212,1495,2143,1495,69,119
그린빌라,42602,1356,3116,1340,3116,16,144
그린힐아파트.e편한세상아파트,40194,317,1821,315,1821,2,68
극동.금호아파트,39272,5061,7501,4898,7501,163,405
극동.금호아파트,39278,6276,5514,6174,5514,102,380
극지연구소,39918,2706,2703,2687,2703,19,174
극지연구소,39919,4235,3032,4201,3032,34,234
근대문화거리입구,35369,2331,4171,2247,4171,84,209
근대문화거리입구,35370,3161,1901,3054,1901,107,163
근로복지공단인천병원,40145,11866,13365,11696,13365,170,813
근로복지공단인천병원,40155,20888,11309,20775,11309,113,1038
글로벌캠퍼스푸르지오,39841,2765,7995,2667,7995,98,347
글로벌파크,39975,612,944,609,944,3,50
글로벌파크,39976,127,1612,120,1612,7,56
글로벌파크베르디움,39840,7143,1716,7066,1716,77,285
금강다이아몬드,39007,621,1760,596,1760,25,76
금강다이아몬드,39008,982,447,980,447,2,46
금강마을,55066,1843,2404,1744,2404,99,137
금강마을,55068,4995,845,4955,845,40,188
금강요양병원,37291,8765,6317,8584,6317,181,486
금강종합상가,42858,993,60,963,60,30,33
금강찜질방,44113,37,16,34,16,3,1
금강찜질방,44149,14,19,14,19,0,1
금강찜질방,44150,33,20,27,20,6,1
금강찜질방,44151,12,2,12,2,0,0
금강탱크터미널,42758,1206,2385,1190,2385,16,115
금강펜테리움더시글로,89392,9179,2196,9110,2196,69,366
금강펜테리움더시글로,89459,6,90,6,90,0,3
금곡교차로,89370,10,58,6,58,4,2
금곡동,42471,8,226,6,226,2,7
금곡동,42587,643,79,636,79,7,23
금곡종점,89319,124,114,119,114,5,7
금란마트,89056,91,1138,78,1138,13,39
금란마트,89061,18,676,6,676,12,22
금마초등학교,40833,7191,4390,6742,4390,449,373
금산경로당,35564,7,128,7,128,0,4
금산경로당,35565,13,3,13,3,0,0
금성목재,42812,1,211,1,211,0,6
금운교,43298,0,43,0,43,0,1
금운교,43858,3,35,3,35,0,1
금월리종점,43777,128,76,119,76,9,6
금정골입구,90301,0,3,0,3,0,0
금정부락,90300,6,2,6,2,0,0
금호2차아파트,37031,6844,1375,6697,1375,147,265
금호2차아파트,37033,1732,4364,1684,4364,48,196
금호베스트빌1단지.영종도서관,35112,1418,2195,1376,2195,42,116
금호베스트빌1단지.영종도서관,35113,4045,1352,3977,1352,68,174
금호아파트,37061,184,484,182,484,2,21
금호아파트,38302,651,790,648,790,3,46
금호아파트,38349,11611,2732,11282,2732,329,462
금호아파트,40441,3921,1125,3845,1125,76,162
금호아파트,40795,20721,19664,20542,19664,179,1302
금호아파트,40845,6951,8311,6813,8311,138,492
금호어울림,35313,3177,1208,3082,1208,95,141
금호어울림,35384,807,2736,776,2736,31,114
금호어울림,37048,1402,1974,1329,1974,73,108
금호어울림2차,35597,6,0,6,0,0,0
금호어울림2차,35598,0,18,0,18,0,0
금호어울림아파트,42137,3746,2683,3699,2683,47,207
금호어울림아파트,42139,2691,2987,2659,2987,32,183
금호어울림아파트,42592,249,967,233,967,16,39
금호어울림아파트,42593,1030,875,1006,875,24,61
금호이수마운트밸리,40316,433,859,426,859,7,41
금호종합열처리,42801,707,146,706,146,1,27
금호타운,37024,15289,3779,14907,3779,382,615
금호타운,37026,4807,15476,4746,15476,61,654
금홍염전,35543,387,244,377,244,10,20
금홍염전,35544,375,3176,367,3176,8,114
기계공고,37294,5195,2890,5003,2890,192,260
기계철제단지,36129,18,246,18,246,0,8
기계철제단지,36149,212,57,211,57,1,8
기신정기,39567,804,1470,796,1470,8,73
기업은행(구월동지점),39178,257,571,248,571,9,26
기업은행앞,70152,216,38,211,38,5,8
긴마루교회입구,35686,70,42,67,42,3,3
긴마루교회입구,35692,9,30,9,30,0,1
길병원,39250,83873,84925,82740,84925,1133,5445
길병원,39262,14882,11650,14619,11650,263,855
길병원,39264,6577,9483,6484,9483,93,518
길병원,39590,79529,71149,78747,71149,782,4860
길병원사거리,39212,21044,20339,20567,20339,477,1334
길병원사거리,39216,21667,25577,21102,25577,565,1524
길상교회,43148,35,4,34,4,1,1
길상교회,43701,6,33,6,33,0,1
길상군립어린이집,43959,73,17,73,17,0,2
길상군립어린이집,43960,34,140,34,140,0,5
길상낚시터,43149,8,12,8,12,0,0
길상낚시터,43883,6,13,3,13,3,0
길상보건지소,43021,260,582,218,582,42,27
길상보건지소,43069,417,378,347,378,70,25
길정저수지,90054,0,5,0,5,0,0
길정저수지,90055,1,4,1,4,0,0
길주초등학교,41654,82,26,81,26,1,3
길직1리,43270,87,175,84,175,3,8
길직리,43031,230,142,210,142,20,12
길직리입구,43304,7,72,6,72,1,2
길직리입구,43313,28,17,28,17,0,1
길훈4차아파트,80040,8,234,8,234,0,7
길훈4차아파트,80041,210,0,209,0,1,6
길훈아파트,42494,8502,8613,8396,8613,106,552
김미현골프장,39749,1281,783,1261,783,20,66
김미현골프장,39751,741,1510,727,1510,14,72
김소골,35675,40,31,39,31,1,2
김소골,35703,22,38,22,38,0,1
김지곡,43455,0,79,0,79,0,2
김지곡,43831,96,1,71,1,25,3
김포공항국내선,25029,3197,3379,3100,3379,97,212
김포공항국내선,25091,517,141,514,141,3,21
김포공항국제선,25006,1046,4425,1034,4425,12,176
김포공항국제선,25164,59,162,57,162,2,7
김포대학입구,80257,490,39,487,39,3,17
김포대학입구,80258,33,521,33,521,0,17
김포초교,80028,144,768,144,768,0,29
김포초교,80030,759,126,756,126,3,28
김포한강신협,80032,1011,781,991,781,20,57
김포한강신협,80035,1068,1277,1053,1277,15,75
까치공원.작전도서관,41149,15109,12124,14912,12124,197,878
까치말사거리,41563,9241,3041,9196,3041,45,396
까치말사거리,41564,2803,7271,2785,7271,18,324
꿈동산.사랑마을,55022,1556,2217,1548,2217,8,121
꿈동산.사랑마을,55024,1464,130,1451,130,13,51
꿈에그린아파트,92023,4072,4804,3992,4804,80,286
나누리병원,40398,30637,20608,30109,20608,528,1653
나누리병원,40784,24870,20903,24548,20903,322,1476
나래병원,38142,2529,1980,2480,1980,49,145
나룻개,35593,39,262,39,262,0,9
나룻개,35594,211,26,199,26,12,7
나룻개입구,35385,27,292,27,292,0,10
나룻개입구,35386,315,23,297,23,18,10
나무깨,90183,3,7,3,7,0,0
나무깨,90184,2,8,2,8,0,0
나무다리,90340,1,22,1,22,0,0
나무다리,90344,31,2,30,2,1,1
나사렛국제병원앞,38068,49840,15477,48507,15477,1333,2107
나은병원,42056,7039,2059,6931,2059,108,293
낚시터매점,43356,8,12,8,12,0,0
낚시터매점,43840,13,1,13,1,0,0
낚시터입구,42802,113,668,113,668,0,25
난곳정미소,90286,70,40,70,40,0,3
난정1리마을회관,90285,28,11,28,11,0,1
난정1리마을회관,90287,6,2,6,2,0,0
난정교회앞,90288,2,0,2,0,0,0
난정보건진료소앞,90289,3,3,3,3,0,0
난정초등학교입구,90305,15,2,15,2,0,0
남광로얄아파트,37257,21035,29088,20549,29088,486,1616
남광하우스토리,42841,3929,742,3821,742,108,150
남광하우스토리,42920,5353,1595,5233,1595,120,224
남광하우스토리,42921,1689,4226,1660,4226,29,190
남동I.C(문학동입구),39168,427,5243,384,5243,43,182
남동경기장,92055,279,83,273,83,6,11
남동경찰서·남촌농산물도매시장,39147,3418,1879,3383,1879,35,170
남동경찰서·남촌농산물도매시장,39148,2394,1519,2301,1519,93,126
남동고등학교,92035,157,187,155,187,2,11
남동고등학교,92036,16,60,16,60,0,2
남동공단2호공원,39075,725,5783,687,5783,38,209
남동공단근린공원앞,39073,5177,843,5151,843,26,194
남동공단우체국,39076,1919,6232,1913,6232,6,262
남동구청,39263,11832,7781,11735,7781,97,632
남동구청,39279,11454,14890,11223,14890,231,849
남동구청역,39318,13023,8534,12886,8534,137,695
남동구청역,39324,13346,15486,13132,15486,214,930
남동구청후문(남동등기소),39287,6593,11202,6498,11202,95,574
남동구청후문(남동등기소),39288,5470,3353,5320,3353,150,284
남동국가산업단지 입구,39853,611,17,585,17,26,20
남동국가산업단지(기신정기),39568,1653,1305,1635,1305,18,95
남동대교,38090,2323,7726,2207,7726,116,324
남동대교(스퀘어원),39063,5500,2925,5245,2925,255,271
남동빌라,39330,5202,1949,5069,1949,133,230
남동세무서,39887,24129,13283,23823,13283,306,1206
남동세무서,39888,15403,24606,15120,24606,283,1290
남동소래아트홀,39743,424,104,421,104,3,17
남동소래아트홀,39744,446,109,446,109,0,17
남동소래아트홀,39748,172,379,172,379,0,17
남동소래아트홀,39792,135,337,135,337,0,15
남동소방서,39252,1181,2630,1158,2630,23,122
남동소방서,39587,11673,7455,11455,7455,218,617
남동시범공단앞,39100,3655,5552,3649,5552,6,297
남동시범공단앞,39102,6632,2917,6585,2917,47,308
남동아시아드럭비경기장,39214,360,910,352,910,8,40
남동아시아드럭비경기장,39215,324,719,273,719,51,33
남동인더스파크역,39074,13012,2138,12887,2138,125,488
남동인더스파크역1번출구,92045,122,3,122,3,0,4
남동인더스파크역1번출구,92050,1,79,1,79,0,2
남동정수장,39372,294,882,283,882,11,37
남동중학교,39220,11702,6617,11511,6617,191,590
남동중학교,39224,6370,5645,6238,5645,132,387
남동체육관,39930,734,904,704,904,30,52
남동체육관,39947,787,1640,770,1640,17,78
남동체육관(체조경기장),39682,1855,2882,1797,2882,58,152
남동체육관(체조경기장),39862,1140,703,1132,703,8,59
남동초등학교,39254,18969,29272,18844,29272,125,1556
남동초등학교,39255,34868,16284,34335,16284,533,1650
남동초등학교,39265,4984,539,4868,539,116,178
남동화원,39300,8126,6587,8035,6587,91,474
남디4거리,35271,186,888,158,888,28,34
남디4거리,35280,386,437,380,437,6,26
남부고가교,40921,6,227,5,227,1,7
남산리,43324,4,0,4,0,0,0
남산리,43628,17,9,15,9,2,0
남산유스호스텔,43982,17,0,17,0,0,0
남산유스호스텔,43985,2,18,2,18,0,0
남산포입구,90030,0,75,0,75,0,2
남산포입구,90031,106,0,94,0,12,3
남성네고개,35426,18,190,18,190,0,6
남성네고개,35427,85,23,82,23,3,3
남씨농원앞,41495,24,111,24,111,0,4
남씨농원앞,41511,43,1,42,1,1,1
남양목재,42814,1,237,1,237,0,7
남인천농협백운지점,37174,251,1008,246,1008,5,40
남인천새마을금고중앙지점,37300,17383,15491,16966,15491,417,1060
남인천여자중학교,39190,19304,6289,18688,6289,616,825
남인천여자중학교,39191,8128,18336,7957,18336,171,853
남중학교,37331,7124,646,6941,646,183,250
남중학교,37336,5592,16691,5464,16691,128,718
남청라TG,89379,78,0,78,0,0,2
남청라TG,89380,5,76,1,76,4,2
남촌농산물도매시장,92031,6279,848,6090,848,189,229
남촌농산물도매시장,92032,79,4015,31,4015,48,132
남촌농산물도매시장채소동앞,92033,66,1639,63,1639,3,55
남촌농산물도매시장채소동앞,92034,418,710,409,710,9,36
남촌동다목적센터,39908,93,1576,87,1576,6,53
남촌동다목적체육센터,39907,352,257,332,257,20,19
남촌동입구,39166,4075,9797,4021,9797,54,447
남촌입구,39156,252,643,219,643,33,28
남촌입구,39157,338,1373,301,1373,37,55
남촌풍림2차아파트,39171,6410,11793,6288,11793,122,587
남촌풍림3차아파트,39165,4675,4560,4618,4560,57,297
남촌풍림3차아파트,39167,4346,5045,4161,5045,185,302
남촌풍림아파트,39172,13176,3432,12980,3432,196,535
남항유어선부두,35078,5723,1768,5386,1768,337,241
남항유어선부두,35079,176,4764,135,4764,41,159
납섬입구,90185,12,10,10,10,2,0
납섬입구,90186,1,13,1,13,0,0
내2리마을회관앞,44138,80,42,75,42,5,3
내2리마을회관앞,44152,5,16,5,16,0,0
내3리다목적회관앞,44121,0,5,0,5,0,0
내3리다목적회관앞,44153,4,1,4,1,0,0
내3리마을회관,44154,11,4,9,4,2,0
내3리마을회관,44155,14,5,13,5,1,0
내3리마을회관,44156,3,21,1,21,2,0
내4리마을회관,44104,15,57,11,57,4,2
내4리마을회관,44157,41,5,30,5,11,1
내7리마을회관,44159,17,15,8,15,9,1
내가면사무소(맞은편),43906,116,67,108,67,8,5
내가면사무소(사무소),43907,84,129,84,129,0,6
내가시장,43392,171,344,169,344,2,16
내가시장,43484,533,252,480,252,53,25
내가초등학교,43368,105,54,89,54,16,5
내가초등학교,43554,53,115,50,115,3,5
내건너,90167,31,58,31,58,0,2
내건너,90168,27,18,26,18,1,1
내동교회,44114,5,11,4,11,1,0
내리교회,43395,34,15,32,15,2,1
내리교회,43543,35,34,32,34,3,2
내리쉼터,43968,4,5,4,5,0,0
내리쉼터,43972,10,3,10,3,0,0
내리어촌계사무실,44135,0,2,0,2,0,0
내리주유소.한국화장품삼거리,57016,1528,1612,1522,1612,6,101
내리주유소.한국화장품삼거리,57018,2185,2179,2173,2179,12,140
내촌,43343,62,42,60,42,2,3
내촌,43581,79,19,74,19,5,3
내촌입구,90394,0,59,0,59,0,1
내촌입구,90395,0,5,0,5,0,0
너출(드무리입구),44086,0,3,0,3,0,0
너출(드무리입구),44161,3,3,3,3,0,0
넘말,43140,1,1,1,1,0,0
넘말,43438,2,6,2,6,0,0
넙디,35574,1635,5783,1565,5783,70,239
넙디,35575,7827,1548,7680,1548,147,302
넙디마을입구,35389,82,95,77,95,5,5
노가리해변,44162,1,0,1,0,0,0
노랑새고개,43273,125,38,119,38,6,5
노랑새고개,43570,42,157,39,157,3,6
노인복지회관,37599,172,840,167,840,5,32
노인인력개발센터,40134,1258,211,1165,211,93,47
노인인력개발센터,40745,151,1274,137,1274,14,45
녹청자박물관,42668,2555,542,2503,542,52,99
녹청자박물관,42669,192,2193,191,2193,1,76
논고개길,39687,2123,2694,2059,2694,64,155
논고개길,39819,2143,2040,2061,2040,82,134
논고개길사거리,39870,601,10,593,10,8,19
논골,35318,8,13,8,13,0,0
논골,35394,42,6,42,6,0,1
논골,44098,1,2,1,2,0,0
논골,44163,0,6,0,6,0,0
논골경로당 입구,35770,18,3,18,3,0,0
논골경로당 입구,35771,3,29,3,29,0,1
논현10단지별빛마을웰카운티A정문,39121,5947,2742,5840,2742,107,280
논현10단지별빛마을웰카운티A후문,39599,882,1674,830,1674,52,82
논현12단지산뒤마을,39609,5896,12638,5849,12638,47,597
논현13단지푸르네마을,39611,4246,6882,4179,6882,67,358
논현13단지푸르네마을,39617,5044,2167,5016,2167,28,232
논현13단지푸르네마을,39618,1675,2802,1645,2802,30,144
논현14단지등대마을,39610,10470,1573,10181,1573,289,388
논현14단지등대마을휴먼시아아파트,39612,9248,4487,8966,4487,282,443
논현1동행정복지센터,39598,1637,1000,1576,1000,61,85
논현2단지범마을,39625,2915,11328,2756,11328,159,459
논현2동행정복지센터,39571,1113,181,1106,181,7,41
논현2동행정복지센터,39572,172,939,163,939,9,35
논현2동행정복지센터,39636,1269,3402,1228,3402,41,150
논현2동행정복지센터,39697,3274,1548,3234,1548,40,155
논현3단지하늘마을301동,39631,110,3319,78,3319,32,110
논현3단지하늘마을302동,39624,18293,5413,18059,5413,234,764
논현3단지하늘마을305동,39626,2445,6373,2381,6373,64,284
논현3단지하늘마을305동,39627,5046,2679,4991,2679,55,249
논현5단지달맞이마을,39079,10125,3455,9557,3455,568,438
논현6단지어진마을한화꿈에그린A정문,39078,3836,7067,3668,7067,168,351
논현8단지동산마을,39104,4853,2302,4785,2302,68,230
논현8단지동산마을,39569,735,887,729,887,6,52
논현8단지동산마을,39570,577,724,551,724,26,41
논현9단지냇마을신영지웰A,39101,2418,3706,2390,3706,28,197
논현9단지냇마을신영지웰A,39602,303,203,290,203,13,16
논현9단지냇마을신영지웰A,39603,30,669,23,669,7,22
논현9단지냇마을신영지웰A정문,39600,2334,1000,2297,1000,37,107
논현고잔동행정복지센터,39707,7905,13950,7661,13950,244,705
논현단풍마을트리플에듀,39582,3962,5733,3865,5733,97,312
논현단풍마을트리플에듀,39616,394,224,389,224,5,19
논현동힐스테이트,39708,22130,9984,21585,9984,545,1035
논현사거리,39504,5740,4487,5639,4487,101,329
논현사거리,39505,4451,4501,4381,4501,70,288
논현센트럴뷰·에코메트로5단지,39693,729,899,667,899,62,52
논현신일해피트리아파트,39088,2358,7522,2278,7522,80,318
논현신일해피트리아파트,39089,7245,3120,7042,3120,203,334
논현역,32007,92,3657,91,3657,1,120
논현역,32008,4775,57,4769,57,6,155
논현유승한내들,39839,1415,2937,1408,2937,7,140
논현유승한내들,39923,3116,963,3067,963,49,131
논현주공1단지,39112,15997,7582,15704,7582,293,760
논현주공2단지,39106,12778,14166,12480,14166,298,869
논현주공아파트(인천금융고),39096,13354,11286,13035,11286,319,794
논현주공아파트(인천금융고),39098,16578,13450,16366,13450,212,968
논현중앙공원·남동논현도서관,39604,342,1911,335,1911,7,72
논현중학교,39573,1809,287,1796,287,13,67
논현중학교,39574,150,1121,150,1121,0,41
논현초등학교,39601,792,2187,758,2187,34,96
논현파크포레,39649,5888,3580,5627,3580,261,305
논현파크포레,39722,1524,3741,1470,3741,54,169
논현포대근린공원,92056,47,29,47,29,0,2
논현푸르지오.유호엔시티,39822,2651,117,2594,117,57,89
논현화훼단지,39830,233,1424,218,1424,15,53
논현화훼단지,39831,318,842,312,842,6,37
농기계은행앞,90036,2,36,0,36,2,1
농기계은행앞,90037,31,0,31,0,0,1
농도원,43178,20,81,19,81,1,3
농도원,43355,160,55,155,55,5,6
농막골,90189,5,0,4,0,1,0
농막골,90190,11,9,1,9,10,0
농산물시장,40688,3456,1349,3363,1349,93,155
농어바위캠핑장,44140,12,2,11,2,1,0
농어바위캠핑장,44164,36,40,35,40,1,2
농어촌공사앞,43268,136,11,122,11,14,4
농어촌공사앞,43489,30,124,23,124,7,4
농업기술센터,43357,239,147,230,147,9,12
농업기술센터,43573,59,213,59,213,0,8
농장주유소,39472,325,1119,324,1119,1,46
농장주유소,39508,242,738,227,738,15,31
농협로타리,40244,1143,2753,1107,2753,36,125
농협로타리,40248,2676,1246,2586,1246,90,126
농협로타리,40251,1143,2609,1127,2609,16,121
농협로타리,40751,4238,2879,4167,2879,71,229
농협하나로마트,44117,4,0,4,0,0,0
농협하나로마트,44165,0,4,0,4,0,0
높은마을입구,35685,87,46,86,46,1,4
높은마을입구,35693,79,43,77,43,2,3
누촌,43238,37,110,29,110,8,4
누촌,43360,106,23,85,23,21,4
뉴그린아트빌,40875,1037,885,1020,885,17,62
뉴그린아트빌,40876,529,1816,517,1816,12,75
뉴서울1차아파트,40275,14698,101,14457,101,241,477
뉴서울3차아파트,41026,1966,4401,1934,4401,32,205
뉴서울3차아파트,41029,9186,1488,9073,1488,113,344
뉴서울3차아파트,41032,1687,5079,1639,5079,48,218
뉴서울6차아파트,41632,1663,379,1646,379,17,65
뉴서울6차아파트,41635,497,1766,479,1766,18,73
뉴서울아파트,38303,1308,1514,1288,1514,20,91
뉴서울아파트,39234,9569,173,9452,173,117,314
뉴서울아파트,39235,284,5373,266,5373,18,182
뉴서울아파트,40505,2388,902,2323,902,65,106
뉴서울아파트,40514,647,463,626,463,21,35
뉴서울아파트,40526,2587,4108,2553,4108,34,215
뉴서울아파트,41153,6015,6212,5908,6212,107,394
뉴서울아파트,89071,7486,19226,7158,19226,328,861
느티나무,43182,4,88,4,88,0,2
느티나무,43232,91,8,84,8,7,3
늘목,35414,143,546,143,546,0,22
늘목,35415,448,123,425,123,23,18
늘목마을입구,35529,12,52,8,52,4,2
늘목마을입구,35725,58,5,57,5,1,2
늘푸른벽산.서강2차,70021,74,2399,20,2399,54,79
능곡마을회관,43553,85,12,72,12,13,3
능곡마을회관,43649,31,52,30,52,1,2
능미,43921,63,3,58,3,5,2
능미,43922,5,65,5,65,0,2
능안,43276,74,46,70,46,4,3
능안,43571,24,65,21,65,3,2
능촌삼거리,90370,0,2,0,2,0,0
능촌입구,43560,13,4,13,4,0,0
능촌입구,43854,3,22,3,22,0,0
능허대공원,38567,311,813,308,813,3,36
다남동소촌마을입구,41329,552,8,541,8,11,18
다남동소촌마을입구,41330,7,587,6,587,1,19
다남동역골입구,41333,8,194,8,194,0,6
다남동역골입구,41334,64,298,62,298,2,11
다남성결교회,41664,7,12,7,12,0,0
다남식당,41477,2106,11256,2083,11256,23,431
다남식당,41478,748,3448,703,3448,45,135
다리목,43717,5,10,4,10,1,0
다리목,43845,6,3,5,3,1,0
다우리농장,44083,4,0,4,0,0,0
다운,43605,85,95,80,95,5,5
다운,43822,137,92,129,92,8,7
다운1리,43582,21,54,21,54,0,2
다운1리,43821,34,30,31,30,3,2
다운마을,43398,9,81,9,81,0,2
다운마을,43824,103,1,98,1,5,3
다임메가타운,40870,80,530,73,530,7,19
단봉초등학교,42380,3410,687,3235,687,175,132
단봉초등학교,42382,793,2895,762,2895,31,118
달빛축제공원,38620,18,71,17,71,1,2
달빛축제공원,38621,31,425,27,425,4,14
달빛축제공원대공연장,38733,210,467,208,467,2,21
달빛축제공원대공연장,38734,822,219,818,219,4,33
담방로사거리,39275,12313,4235,12094,4235,219,533
담방아파트,39226,577,82,570,82,7,21
당곡고개,80048,87,546,87,546,0,20
당곡고개,80049,544,17,538,17,6,18
당미마을,41552,4863,6750,4819,6750,44,374
당미마을,41553,4766,3608,4637,3608,129,270
당산리,43450,2,104,2,104,0,3
당산리,43700,129,5,126,5,3,4
당산리검문소,43699,196,31,183,31,13,7
당산리검문소,43752,6,122,6,122,0,4
당산종점,43669,0,33,0,33,0,1
당산종점,43725,41,3,40,3,1,1
당산초등학교,41418,6457,3500,6351,3500,106,321
당산초등학교,41419,2492,3379,2480,3379,12,189
당산초등학교아래사거리,41644,33,222,33,222,0,8
당산초등학교아래사거리,41645,663,383,662,383,1,33
당하금호어울림1차,42435,163,507,155,507,8,21
당하농원,42388,6,29,6,29,0,1
당하농원,42390,5,53,3,53,2,1
당하대주파크빌,42392,1623,1196,1593,1196,30,90
당하동탑스빌아파트,42639,4713,3195,4614,3195,99,255
당하동행정복지센터,42886,8729,4695,8508,4695,221,433
당하마트,42618,21,46,21,46,0,2
당하마트,42619,1,134,1,134,0,4
당하메디칼,42402,1534,2186,1498,2186,36,120
당하초등학교,42396,1735,803,1700,803,35,81
당하초등학교,42399,1094,1349,1081,1349,13,78
당하탑스빌아파트,42393,2944,2878,2813,2878,131,187
당하푸르지오,42403,1203,767,1142,767,61,63
당하푸르지오,42502,223,1965,223,1965,0,70
당하풍림아파트,42405,2364,13201,2299,13201,65,502
대경화성,39789,1404,805,1404,805,0,71
대경화성,39790,1081,1976,1070,1976,11,98
대곶사거리,80008,1725,5128,1633,5128,92,221
대곶사거리,80009,6171,1578,6009,1578,162,249
대기이에스티,39013,392,310,387,310,5,22
대덕강업앞,42759,9,486,9,486,0,15
대동1차후문(종점),40553,348,764,339,764,9,35
대동도어(주),39983,385,26,382,26,3,13
대동도어(주),39984,5,513,5,513,0,16
대동아파트,37042,8133,2204,8034,2204,99,333
대동아파트,37504,4275,7142,4185,7142,90,368
대동아파트,38128,6483,11366,6333,11366,150,575
대동아파트,38345,5437,5827,5302,5827,135,363
대동아파트,39256,425,5604,404,5604,21,194
대동아파트,39473,4832,226,4785,226,47,163
대동아파트,39474,107,8086,96,8086,11,264
대동아파트,40491,719,223,692,223,27,30
대동아파트,40569,8817,3437,8489,3437,328,395
대동아파트,41172,2538,652,2483,652,55,102
대동아파트,42304,2685,4021,2630,4021,55,216
대동아파트,42306,3068,2064,3025,2064,43,165
대동아파트정문앞,40277,1508,841,1450,841,58,75
대동아파트후문,41137,2207,5059,2194,5059,13,234
대동월드,38116,5170,2801,4936,2801,234,257
대동특수철강,39049,115,1198,113,1198,2,42
대룡2리마을회관앞,90026,5,64,3,64,2,2
대룡2리마을회관앞,90027,95,4,83,4,12,3
대룡시장,90020,329,1519,323,1519,6,59
대룡시장,90021,1538,427,1476,427,62,63
대륭맨숀,40242,8779,5412,8699,5412,80,457
대륭맨숀,40247,9227,10021,9058,10021,169,620
대림3차아파트301동앞,38681,197,34,195,34,2,7
대림3차아파트301동앞,38684,46,572,45,572,1,19
대림아파트,37053,11034,4033,10789,4033,245,486
대림아파트,37054,3241,7535,3162,7535,79,347
대림아파트,38257,5028,1622,4984,1622,44,214
대림아파트,40382,3446,11743,3393,11743,53,489
대림아파트,42609,1799,1791,1630,1791,169,115
대림아파트,42610,250,2025,228,2025,22,73
대림아파트후문,40397,1897,1312,1840,1312,57,103
대명아파트,37537,2417,7324,2390,7324,27,314
대명초교,80002,1850,96,1758,96,92,62
대명초교,80003,230,1561,218,1561,12,57
대문리고개입구,43546,621,317,566,317,55,30
대문목재,89206,26,41,26,41,0,2
대문목재,89207,189,1,185,1,4,6
대문촌마을,90058,1,4,1,4,0,0
대문촌마을,90059,3,0,3,0,0,0
대박주유소,36091,2430,2588,2389,2588,41,161
대부고교차로,18388,7,5,7,5,0,0
대부관광호텔,62040,284,52,284,52,0,10
대부도서관,18389,1,14,1,14,0,0
대부도서관,18391,10,17,6,17,4,0
대부동행정복지센터,62011,422,1458,369,1458,53,60
대부동행정복지센터,62012,1361,279,1322,279,39,52
대부중고등학교,62027,408,114,393,114,15,16
대부중고등학교,62028,75,232,75,232,0,9
대부파출소앞,62036,1,109,1,109,0,3
대부파출소앞,62042,135,2,131,2,4,4
대사마을,43947,7,177,7,177,0,5
대사마을,43948,131,10,127,10,4,4
대산-기점,90259,1765,1718,1740,1718,25,112
대상스틸,89007,39,571,39,571,0,19
대성베르힐아파트(가정성당),89240,1501,2855,1443,2855,58,140
대성베르힐아파트(가정성당),89241,5180,2183,5132,2183,48,237
대성유니드아파트,40674,1004,3891,975,3891,29,157
대성유니드아파트,40675,2164,309,2132,309,32,79
대신아파트,41406,6052,1966,5984,1966,68,258
대신철강,42859,20,1172,20,1172,0,38
대야초교.ABC학습타운입구,70017,262,1834,226,1834,36,67
대야초교.ABC학습타운입구,70020,2122,416,2061,416,61,81
대양자동차학원,35073,26,2633,15,2633,11,85
대우삼환아파트,38078,6933,4589,6764,4589,169,371
대우삼환아파트,38591,1379,3342,1335,3342,44,152
대우실업,41485,32,26,32,26,0,1
대우실업,41505,35,0,34,0,1,1
대우아파트,38206,4043,4331,3935,4331,108,270
대우아파트,38208,4403,2966,4290,2966,113,237
대우아파트,40321,194,430,188,430,6,20
대우아파트,40340,977,498,938,498,39,47
대우일렉트로닉스,37462,89,1504,68,1504,21,51
대우일렉트로닉스,37463,505,515,483,515,22,32
대우자동차운전학원,42262,313,198,309,198,4,16
대우자동차운전학원,42263,180,357,180,357,0,17
대우재아파트,39702,3,450,1,450,2,14
대우재아파트,39703,556,504,553,504,3,34
대우푸르지오,42407,26347,6917,25705,6917,642,1073
대우푸르지오,42842,927,4412,872,4412,55,172
대우푸르지오복합상가,39605,2897,1870,2715,1870,182,153
대우하나아파트,89073,18528,9057,18292,9057,236,889
대우하나아파트,89074,7774,11615,7678,11615,96,625
대웅실업앞,92003,76,310,74,310,2,12
대원레스피아1단지아파트,42643,8236,39,8074,39,162,266
대원정밀,39475,500,1013,489,1013,11,48
대월초등학교,90094,0,1,0,1,0,0
대월초등학교,90095,2,0,2,0,0,0
대은교회,42143,4862,9045,4644,9045,218,448
대인고등학교,42344,2368,2386,2342,2386,26,153
대인고등학교,42345,3550,1743,3459,1743,91,170
대일엠앤쿡,39059,1038,2430,1032,2430,6,111
대장간마을,43703,313,119,275,119,38,13
대정,90117,2,46,2,46,0,1
대정,90118,40,18,40,18,0,1
대주아파트,42469,2018,10999,1893,10999,125,419
대주파크빌,42466,5632,1398,5415,1398,217,226
대진아파트,40415,1767,2845,1761,2845,6,148
대촌,43393,72,57,68,57,4,4
대촌,43545,44,24,42,24,2,2
대촌마을,41663,17,3,17,3,0,0
대토단지앞,39813,1173,18,1127,18,46,38
대한솔루션알앤디센터,39557,70,158,70,158,0,7
대한제당,35169,1619,56,1600,56,19,54
대한제당,35220,37,1789,35,1789,2,58
대현목재,89205,215,42,200,42,15,8
대화초등학교,37397,6565,2868,6505,2868,60,304
대화초등학교,37399,3446,4898,3403,4898,43,269
대흥,43194,28,274,26,274,2,9
대흥,43591,323,47,308,47,15,11
대흥식당,35688,54,9,49,9,5,2
대흥식당,35689,10,70,8,70,2,2
더리미경로당,43363,32,12,29,12,3,1
더리미경로당,43731,22,18,19,18,3,1
더리미미술관,43961,64,24,45,24,19,2
더리미미술관,43962,12,6,1,6,11,0
더리미장어마을,43680,9,47,7,47,2,1
더리미장어마을,43864,38,3,38,3,0,1
더샵그린스퀘어105동,92021,1354,148,1301,148,53,48
더샵그린스퀘어107동,92022,146,1855,139,1855,7,64
더샵그린애비뉴,38486,6241,8145,5983,8145,258,464
더샵그린애비뉴,38510,756,985,715,985,41,56
더샵그린애비뉴,38511,1193,508,1102,508,91,54
더샵그린워크1단지,38495,6024,2429,5891,2429,133,272
더샵부평센트럴시티(101동),40061,669,2149,666,2149,3,90
더샵부평센트럴시티(101동),40065,1578,434,1559,434,19,64
더샵부평센트럴시티(127동),40050,5025,7222,4936,7222,89,395
더샵센트럴시티204동,92020,140,1717,131,1717,9,59
더샵센트럴시티205동,92019,4298,2904,4241,2904,57,232
더샵송도프라임뷰20단지,38561,1032,2295,978,2295,54,107
더샵엑스포빌리지,38480,8939,3234,8760,3234,179,392
더샵퍼스트파크13단지,38601,992,202,966,202,26,38
더샵퍼스트파크13단지,38602,192,655,188,655,4,27
더샵하버뷰,38485,10540,5294,10351,5294,189,510
더샵하버뷰,38487,3401,3285,3338,3285,63,215
더샵하버뷰(D13),38453,429,488,387,488,42,29
더샵하버뷰(D13),38466,891,670,867,670,24,50
더샵하버뷰(D14),38454,218,226,207,226,11,14
더샵하버뷰14단지,38504,1627,499,1607,499,20,68
더월드스테이트2단지,37657,776,406,753,406,23,38
더월드스테이트후문,37422,50,661,48,661,2,22
더포레스트아파트,39876,15411,1953,15389,1953,22,560
더포레스트아파트,39877,4712,12015,4688,12015,24,539
더프라우,38410,7703,21419,7337,21419,366,939
더필립요양병원,40461,1987,4109,1937,4109,50,196
덕고개삼거리,43723,45,33,41,33,4,2
덕고개삼거리,43750,11,64,11,64,0,2
덕골,43397,10,1,10,1,0,0
덕골,43399,10,16,9,16,1,0
덕교3거리,35012,117,50,117,50,0,5
덕교동,35003,805,248,789,248,16,33
덕교동,35005,260,2312,254,2312,6,82
덕교동,35259,978,133,970,133,8,35
덕교삼거리,35214,92,189,90,189,2,9
덕신고등학교(강화읍교회),90228,11,103,11,103,0,3
덕신고등학교(강화읍교회),90229,84,188,82,188,2,8
덕유마을.설악마을,55073,1619,736,1589,736,30,75
덕음,43657,27,12,26,12,1,1
덕응,43983,0,6,0,6,0,0
덕응,43986,17,20,16,20,1,1
덕정가든,43173,3,19,3,19,0,0
덕정가든,43296,34,1,34,1,0,1
덕진사거리,43870,59,9,58,9,1,2
덕진사거리,90310,16,36,15,36,1,1
덕진진,43637,8,115,7,115,1,3
덕진진,43672,59,11,55,11,4,2
덕창기계,39723,249,102,249,102,0,11
덕포리,43006,472,245,468,245,4,23
덕포리,43100,187,335,183,335,4,16
덕하교앞,43449,43,26,42,26,1,2
덕하교앞,43727,21,45,19,45,2,2
덕화2리,43468,48,16,47,16,1,2
덕화2리,43730,2,19,2,19,0,0
덕화2리마을회관,43923,41,14,40,14,1,1
덕화2리마을회관,43924,4,22,4,22,0,0
덕화3리마을회관,43609,166,106,157,106,9,8
덕화3리입구,43469,8,1,7,1,1,0
덕화3리입구,43729,17,46,16,46,1,2
덕화교회앞,90398,0,10,0,10,0,0
덕화교회앞,90399,0,6,0,6,0,0
도간마을,43612,38,0,33,0,5,1
도간마을,43664,1,38,1,38,0,1
도감말,43733,27,20,25,20,2,1
도감말,43754,10,22,10,22,0,1
도곡한신아파트,23504,36,57,36,57,0,3
도담공원.푸르지오더베뉴,89398,3630,552,3523,552,107,134
도두리마을,41565,12907,1472,12862,1472,45,463
도두리마을,41566,2071,11568,2053,11568,18,439
도림동고개,39160,1641,764,1621,764,20,77
도림동고개,39161,728,1703,712,1703,16,78
도림동입구,39140,8345,1355,8286,1355,59,312
도림동입구,39141,11,2646,11,2646,0,85
도림아이파크아파트,39155,7886,3864,7743,3864,143,379
도림육교,39154,2966,6330,2908,6330,58,299
도림주공1단지,39152,17157,13323,16789,13323,368,983
도림주공1단지,39153,16082,11483,15787,11483,295,889
도림주공208동,39142,7531,3328,7329,3328,202,350
도림주공208동,39143,5481,8235,5400,8235,81,442
도림주공2단지,39146,5513,4533,5435,4533,78,324
도림주공2단지,39149,3715,2764,3633,2764,82,209
도림주철관1공장,89307,283,604,280,604,3,28
도림주철관공업(주),42293,3606,1041,3555,1041,51,149
도림포도원,39150,410,3923,406,3923,4,139
도림포도원,39151,534,446,532,446,2,31
도원고개(도원역),36001,4614,3879,4419,3879,195,273
도원고개(동구청방향),36170,15,22,15,22,0,1
도원동행정복지센터,35180,3531,2789,3382,2789,149,203
도원동행정복지센터,36128,59,299,56,299,3,11
도원동행정복지센터(앞),35788,191,92,185,92,6,9
도원동행정복지센터(앞),35798,183,52,174,52,9,7
도원역(인천축구전용경기장),35176,10357,4671,9899,4671,458,484
도원역(인천축구전용경기장),37549,1030,4663,999,4663,31,183
도장골삼거리,44122,4,2,3,2,1,0
도장재마을,43167,20,0,17,0,3,0
도장재마을,43225,6,15,6,15,0,0
도화1동행정복지센터,37340,13311,12327,12906,12327,405,827
도화IC,37356,27120,21588,26797,21588,323,1571
도화e편한세상604동,37578,998,15,982,15,16,32
도화e편한세상아파트,37612,213,1616,204,1616,9,59
도화e편한세상아파트,37613,4736,1533,4702,1533,34,202
도화e편한세상아파트5단지,37624,3556,1303,3459,1303,97,156
도화e편한세상아파트6단지,37626,2294,3808,2255,3808,39,196
도화동신협(구박문여고),36003,11147,4682,10930,4682,217,510
도화동신협(구박문여고),37499,5122,7145,5017,7145,105,395
도화사거리.도화역,37390,973,717,957,717,16,54
도화사거리.도화역,37392,412,1072,400,1072,12,47
도화서희스타힐스,37625,1183,2554,1170,2554,13,120
도화역,37629,5691,6291,5642,6291,49,386
도화초등학교.수봉도서관,37366,8462,7030,8263,7030,199,499
도화초등학교.수봉도서관,37367,13379,13821,12970,13821,409,877
독골사거리,42175,3290,1445,3220,1445,70,152
독배로317번길(삼거리),37634,7531,239,7406,239,125,250
독장골,43351,2,26,2,26,0,0
독장골,43846,8,1,8,1,0,0
독정역(서구동구예비군훈련장),42377,3473,3316,3386,3316,87,219
독정역(서구동구예비군훈련장),42378,6242,4320,6127,4320,115,340
독정이고개,37234,31863,21152,31268,21152,595,1710
독정이고개,37238,20673,27567,20208,27567,465,1556
돈대마을,43925,32,7,32,7,0,1
돈대마을,43926,4,29,4,29,0,1
돈대모루,43422,7,12,6,12,1,0
돈대모루,43447,23,12,20,12,3,1
돌고래펜션,44127,2,3,2,3,0,0
돌머루(대산종점),43707,108,66,108,66,0,5
돌산밑,35320,185,75,181,75,4,8
돌산밑,35396,65,178,63,178,2,7
돌성,43364,61,196,61,196,0,8
돌성,43587,265,23,260,23,5,9
돌팍재삼거리,35273,557,727,536,727,21,41
돌팍재삼거리,35277,859,522,832,522,27,44
돌팍재한뿌리,35304,253,209,239,209,14,14
돌팍재한뿌리,35315,164,356,160,356,4,16
동강리,35245,77,66,73,66,4,4
동강리,35246,94,65,89,65,5,5
동강리,35317,33,63,32,63,1,3
동강리,35393,100,32,98,32,2,4
동검도삼거리,43223,0,36,0,36,0,1
동검도삼거리,43642,68,3,66,3,2,2
동검리마을회관입구,90069,1,20,1,20,0,0
동검리마을회관입구,90070,17,2,17,2,0,0
동검리입구,43856,2,10,2,10,0,0
동검리입구,43877,36,0,30,0,6,1
동검리종점,43889,83,35,75,35,8,3
동검상회,43226,2,0,2,0,0,0
동검상회,43519,0,7,0,7,0,0
동광리어,41083,1399,429,1370,429,29,58
동광리어,41084,728,2512,707,2512,21,104
동광제일교회,40411,565,500,552,500,13,34
동교동삼거리,22012,8117,67,8099,67,18,264
동교동삼거리,23033,106,6542,106,6542,0,214
동구노인인력개발센터,36178,0,5,0,5,0,0
동구선거관리위원회,36110,4455,10851,4370,10851,85,493
동구청,36011,612,503,602,503,10,35
동구청,36166,9,28,9,28,0,1
동구청소년수련관.달동네박물관,36026,19889,16858,19214,16858,675,1185
동구환경,36181,0,1,0,1,0,0
동국제강,36068,2058,3382,2009,3382,49,175
동국제강,36074,232,151,232,151,0,12
동국제강후문,36069,181,673,178,673,3,27
동국제강후문,36070,866,153,855,153,11,32
동남스포피아,38226,11119,7595,10820,7595,299,603
동남스포피아,38227,11058,9870,10694,9870,364,675
동남아파트,38267,1007,5371,966,5371,41,205
동남아파트,38268,2504,865,2425,865,79,108
동남아파트,70039,481,722,466,722,15,38
동남아파트(무지개아파트),38337,1510,4356,853,4356,657,189
동녘개,90147,0,35,0,35,0,1
동녘개,90148,57,23,55,23,2,2
동녘마을입구,39660,37,923,37,923,0,30
동들머리,43705,28,10,25,10,3,1
동들머리,43885,51,71,46,71,5,3
동막교회,43499,10,34,9,34,1,1
동막교회,43514,71,5,64,5,7,2
동막역(1번출구),38039,37560,53514,37294,53514,266,2937
동막역(3번출구),38433,51367,28153,50957,28153,410,2565
동막역(4번출구),38338,9100,1096,9066,1096,34,328
동막초등학교,38054,991,4644,940,4644,51,181
동막해변,43408,92,195,88,195,4,9
동막해변,43511,278,92,264,92,14,11
동문아파트,42436,13251,16066,13064,16066,187,945
동방중학교,92038,401,445,368,445,33,27
동방초등학교,92037,20,174,18,174,2,6
동보2차아파트,41053,44,752,41,752,3,25
동보2차아파트,41059,1077,114,1063,114,14,38
동보노빌리티,35488,3781,3246,3620,3246,161,226
동보노빌리티,35489,2234,3326,2154,3326,80,179
동보아파트,39125,3580,5565,3476,5565,104,295
동보아파트,39126,5603,1768,5523,1768,80,237
동보아파트,41056,4393,603,4246,603,147,161
동보아파트,41063,743,4058,706,4058,37,154
동보아파트,41136,330,1223,304,1223,26,50
동보아파트,41143,14640,16843,14421,16843,219,1015
동보아파트,70040,446,672,441,672,5,36
동보아파트후문,41129,1481,205,1455,205,26,54
동부아파트,36052,1327,2139,1256,2139,71,111
동부아파트,37192,288,471,281,471,7,24
동산고,36018,13496,4625,13218,4625,278,584
동산고등학교,36021,6590,13094,6303,13094,287,634
동산교회,36010,2525,3183,2453,3183,72,184
동산교회,36012,3394,5089,3245,5089,149,273
동산리마을회관,90302,21,4,21,4,0,0
동산리입구,90291,8,9,8,9,0,0
동산중고등학교(재능대정문),36029,9695,1335,9610,1335,85,355
동산휴먼시아2단지,36022,3266,477,3184,477,82,120
동산휴먼시아2단지,36023,860,4143,826,4143,34,161
동산휴먼시아2단지정문,36177,4,1,4,1,0,0
동서식품,40623,2397,3073,2368,3073,29,176
동서식품,40624,2452,3695,2442,3695,10,198
동성.길훈아파트,42495,3214,5141,3169,5141,45,269
동성아파트,42496,4786,2133,4737,2133,49,223
동수교회,40184,134,1347,118,1347,16,47
동수역,40108,3332,6645,3293,6645,39,321
동수역,40110,8062,5802,7947,5802,115,447
동수역,40124,2146,13206,2064,13206,82,495
동수치안센터,40188,10284,9337,10030,9337,254,632
동수치안센터,40189,12221,13404,11949,13404,272,826
동아.팬더아파트,39233,7534,10182,7439,10182,95,571
동아.팬더아파트,39236,10382,6229,10286,6229,96,535
동아2단지정문,40324,1317,510,1288,510,29,58
동아금호아파트,38344,5347,12392,5242,12392,105,572
동아금호아파트,38347,7799,2605,7714,2605,85,335
동아아파트,37248,931,1393,918,1393,13,74
동아아파트,41070,2965,886,2873,886,92,124
동아아파트,41072,863,2817,834,2817,29,118
동아아파트,41403,994,4135,969,4135,25,165
동아아파트,42404,3989,4576,3879,4576,110,276
동아아파트,42406,6720,3775,6532,3775,188,338
동아아파트후문,40257,1989,2318,1948,2318,41,138
동아아파트후문,40258,2245,1724,2217,1724,28,128
동아전기,42647,6,166,6,166,0,5
동아전기,42725,6,388,6,388,0,12
동아정밀,42037,1383,2837,1359,2837,24,136
동아풍림아파트,37037,15715,18528,15180,18528,535,1104
동암국민주택,40014,3602,773,3544,773,58,141
동암국민주택,40015,731,1963,719,1963,12,86
동암남부역,40034,43899,26825,43341,26825,558,2281
동암남부역,40797,140313,123716,139134,123716,1179,8517
동암남부역,40861,1075,8403,1068,8403,7,305
동암남부역,40862,18164,14910,17956,14910,208,1066
동암마트,40039,97,1499,88,1499,9,51
동암북부역,40013,35448,14662,35003,14662,445,1616
동암북부역,40035,10293,31192,10174,31192,119,1338
동암북부역광장,40800,59645,48281,59007,48281,638,3481
동암사거리,40001,13684,15394,13552,15394,132,938
동암사거리,40003,3844,5406,3794,5406,50,298
동양도서관,41522,7636,4222,7518,4222,118,382
동양도서관(휴먼빌아파트),41523,4354,5776,4298,5776,56,326
동양엔파트4단지,42820,2307,4931,2151,4931,156,233
동양엔파트4단지,42837,4320,1884,4210,1884,110,200
동양엔파트5단지,42986,2776,3031,2633,3031,143,187
동양자이입구,41554,3408,4447,3363,4447,45,253
동양자이입구,41555,4154,3354,4109,3354,45,242
동양장사거리,37301,7062,5812,6951,5812,111,415
동양주공1.2단지,41372,13590,3298,13320,3298,270,544
동양주공1.2단지,41373,3208,8982,3135,8982,73,393
동양지구1단지정문,41521,491,1606,489,1606,2,67
동양지구입구,41445,5194,540,5062,540,132,184
동양지구입구,41446,1080,7343,1076,7343,4,271
동양하이테크,42966,18,193,18,193,0,6
동원아파트,25166,162,320,161,320,1,15
동원아파트,25167,318,101,312,101,6,13
동원아파트,37376,4927,2421,4820,2421,107,237
동원아파트,37379,2064,3338,1968,3338,96,174
동인천,35188,34154,38580,33744,38580,410,2346
동인천(우리은행앞),35517,955,681,922,681,33,52
동인천동행정복지센터,35795,20,386,16,386,4,13
동인천동행정복지센터,35805,65,143,60,143,5,6
동인천역,35185,109891,55853,107993,55853,1898,5346
동인천역,35187,6082,10128,5901,10128,181,522
동인천역,35191,82578,95997,81136,95997,1442,5760
동인천역,35192,11991,24088,11388,24088,603,1163
동인천역북광장,36136,26856,17998,26445,17998,411,1446
동인천역북광장,36137,30057,16028,29531,16028,526,1486
동인천중학교,39229,1563,960,1542,960,21,81
동인천중학교,39230,1880,1336,1833,1336,47,103
동일방직,36031,4112,3705,3989,3705,123,252
동일방직,36032,4005,2750,3953,2750,52,217
동일아파트,35177,393,1451,362,1451,31,59
동주농장,43349,4,10,1,10,3,0
동주농장,43401,32,3,29,3,3,1
동촌,43407,117,1,112,1,5,3
동촌,43793,0,87,0,87,0,2
동춘2동행정복지센터,38045,1277,6142,1184,6142,93,239
동춘2동행정복지센터,38046,6105,695,5921,695,184,219
동춘동종점,38037,360,996,263,996,97,43
동춘동차고지,38569,432,256,296,256,136,22
동춘롤러경기장,38704,364,453,332,453,32,26
동춘마을아파트,38082,7061,5633,6883,5633,178,409
동춘마을아파트,38087,3410,7082,3256,7082,154,338
동춘역,38346,30839,20501,30520,20501,319,1656
동춘역(이마트),38060,13492,732,13414,732,78,458
동춘역(이마트.스퀘어원),38070,29464,38932,29162,38932,302,2206
돼지슈퍼.간동입구,80019,113,827,113,827,0,30
두두미마을,43289,4,1,4,1,0,0
두두미마을,43869,0,4,0,4,0,0
두밀경노당,89328,7,118,6,118,1,4
두밀경노당,89331,90,3,90,3,0,3
두산아파트,40564,2213,4067,2075,4067,138,202
두산위브아파트,37043,15009,8342,14745,8342,264,753
두산위브아파트,40630,10880,494,10737,494,143,366
두산위브아파트,40648,384,1017,372,1017,12,45
두운1리마을회관앞,90047,1,43,1,43,0,1
두운1리마을회관앞,90048,24,3,24,3,0,0
두운리,43034,41,39,40,39,1,2
두운리,43540,103,191,93,191,10,9
둑실경로당,41498,4,41,4,41,0,1
둑실경로당,41514,40,0,39,0,1,1
둑실동(아라마루전망대),41494,29,54,26,54,3,2
둑실동(아라마루전망대),41512,195,2,195,2,0,6
둑실동회차지,41500,96,65,96,65,0,5
둥개마을오거리,35861,31,5,31,5,0,1
둥개마을오거리,35862,9,3,9,3,0,0
둥깨마을입구(세븐일레븐),35721,12,74,12,74,0,2
둥깨마을입구(세븐일레븐),35722,64,6,64,6,0,2
둥깨마을입구(용성철강),35723,0,5,0,5,0,0
둥깨마을입구(용성철강),35724,54,1,54,1,0,1
뒤골입구,35668,28,0,28,0,0,0
뒤골입구,35669,0,14,0,14,0,0
뒷골 입구,90377,6,53,6,53,0,1
뒷골 입구,90380,72,0,70,0,2,2
뒷방죽들,39959,770,29,765,29,5,25
뒷방죽들,39960,7231,8146,7188,8146,43,496
드라이빙센터,35589,78,913,76,913,2,31
드림로갈산교,41342,54,72,54,72,0,4
드림로갈산교,41343,60,574,60,574,0,20
드림파크야생화단지,89363,1117,16,909,16,208,36
드림파크야생화단지,89364,148,1003,3,1003,145,37
드림파크어울림,89201,17,269,12,269,5,9
드림파크어울림,89202,0,20,0,20,0,0
드무리해변,44011,29,652,26,652,3,21
드무리해변,44012,628,30,620,30,8,21
디에스솔텍,39035,3021,2155,2952,2155,69,166
디에스솔텍,39038,2494,2221,2472,2221,22,152
디에트로더힐,89455,2,8,2,8,0,0
뗏마루어린이공원·신화아파트,39405,4727,6747,4615,6747,112,370
라이크홈기숙사앞,39993,1997,870,1984,870,13,92
라이크홈기숙사앞,39994,2035,1842,2024,1842,11,125
라이크홈기숙사앞,39995,1332,104,1305,104,27,46
라이크홈기숙사앞,39996,84,942,62,942,22,33
라이프쇼핑앞,35070,6829,4916,6535,4916,294,378
라이프아파트,35060,159,5461,135,5461,24,181
라이프아파트,35062,12888,122,12558,122,330,419
래미안아파트파이낸셜뉴스,31072,10310,8793,10286,8793,24,616
래미안아파트파이낸셜뉴스,32002,3806,1613,3803,1613,3,174
랜드마크시티센트럴더샵,38636,50,2556,49,2556,1,84
랜드마크시티센트럴더샵(106동),38665,914,7037,899,7037,15,256
랜드마크시티센트럴더샵(106동),38666,6644,600,6457,600,187,233
랜드마크시티센트럴더샵(203동),38645,7618,510,7501,510,117,262
랜드마크시티센트럴더샵(203동),38650,621,6599,597,6599,24,232
럭키아파트,23488,299,152,299,152,0,14
럭키아파트,38115,4509,137,4352,137,157,149
럭키아파트,38132,1475,9639,1450,9639,25,358
레이크파크,42840,1752,5204,1638,5204,114,224
레전드호텔,35639,1996,1784,1977,1784,19,121
레전드호텔,35640,1296,1710,1262,1710,34,96
레지던스라이크홈,92012,403,4248,401,4248,2,150
로봇랜드입구,89022,3682,90,3626,90,56,121
로봇랜드입구,89023,35,2059,25,2059,10,67
로봇타워,89301,2,236,2,236,0,7
로봇타워,89302,552,36,379,36,173,18
로얄금속,40599,6117,3634,6053,3634,64,314
로얄아파트,37247,33552,14897,33131,14897,421,1562
로얄아파트,37424,641,307,625,307,16,30
로얄타운,42047,1814,2505,1782,2505,32,139
로얄호텔,43542,4,45,4,45,0,1
로얄호텔,43878,32,16,32,16,0,1
롯데마트,35108,2899,4735,2779,4735,120,246
롯데마트,41390,1003,44,985,44,18,33
롯데마트,41391,56,2093,49,2093,7,69
롯데마트,42829,16473,9217,16402,9217,71,828
롯데마트,42838,8757,17907,8613,17907,144,860
롯데마트계양점(고용복지센터),41227,29619,18901,29078,18901,541,1565
롯데마트계양점(고용복지센터),41424,10885,19950,10761,19950,124,994
롯데마트송도점,38523,2511,770,2444,770,67,105
롯데몰.김포공항,25174,325,1362,323,1362,2,54
롯데백화점(인천터미널),37513,199431,177410,195953,177410,3478,12156
롯데백화점(인천터미널),39588,189134,133935,185357,133935,3777,10421
롯데슈퍼,38072,8137,2846,7994,2846,143,354
롯데슈퍼,38074,2420,7625,2358,7625,62,324
롯데슈퍼,42206,2884,4621,2772,4621,112,242
롯데슈퍼,42207,7457,2609,7283,2609,174,324
롯데아파트,38110,6735,9250,6597,9250,138,515
롯데우람아파트,42152,4594,6576,4553,6576,41,360
롯데우람아파트,42603,3395,4927,3334,4927,61,268
롯데월드타워,37327,2949,5561,2845,5561,104,274
롯데캐슬,39795,366,213,355,213,11,18
롯데캐슬,39796,2165,920,2105,920,60,99
롯데캐슬,39797,415,109,384,109,31,16
롯데캐슬,39798,96,284,92,284,4,12
롯데캐슬,42835,7444,4777,7330,4777,114,394
롯데캐슬,42884,5562,10397,5102,10397,460,514
롯데캐슬,42999,1030,3398,981,3398,49,142
롯데캐슬.모래내시장,39309,60561,23111,59540,23111,1021,2699
롯데캐슬·모래내시장·구월시장,39310,32232,55769,31731,55769,501,2838
롯데캐슬캠퍼스타운,39977,21,623,15,623,6,20
롯데캐슬캠퍼스타운,39978,1784,2269,1737,2269,47,130
롯데캐슬후문,39285,4381,4035,4324,4035,57,271
루에블리아파트,89283,828,4324,776,4324,52,166
루에블리아파트,89284,6205,6813,6062,6813,143,419
루원더퍼스트아파트,89107,3414,5564,3280,5564,134,289
루원더퍼스트아파트,89108,7977,1981,7930,1981,47,321
루원더퍼스트아파트105동앞,89378,85,1332,84,1332,1,45
루원숲속마을,89383,122,422,122,422,0,17
루원숲속마을,89384,357,158,356,158,1,16
루원시티2차리더스뷰아파트,89072,4230,5156,4184,5156,46,302
루원시티사거리,89076,393,608,359,608,34,32
루원시티프라디움,89150,16041,3478,15926,3478,115,629
루원시티프라디움105동,89308,6292,11154,6130,11154,162,562
루원시티프라디움105동,89309,3146,5664,3073,5664,73,284
루원이편한세상하늘채(107동),42225,8832,17676,8681,17676,151,855
루원이편한세상하늘채(112동),42721,5161,1967,5038,1967,123,229
루원이편한세상하늘채(125동),42216,6548,2990,6436,2990,112,307
루원제일풍경채정문앞,89040,3313,9904,3240,9904,73,426
루원지웰시티푸르지오,42228,5154,6401,4899,6401,255,372
루원호반베르디움,89149,5241,12672,5070,12672,171,577
루원호반베르디움104동,89368,545,1072,543,1072,2,52
리안월드입구,90177,45,56,43,56,2,3
리안월드입구,90178,41,26,41,26,0,2
린나이코리아,40011,10,323,1,323,9,10
린나이코리아,40012,419,0,416,0,3,13
린스트라우스,42881,8023,2762,7786,2762,237,347
린스트라우스정문,42795,6810,3830,6716,3830,94,343
린스트리우스,42831,2511,2713,2475,2713,36,168
마그네,43028,184,249,170,249,14,13
마그네다리,43158,332,162,328,162,4,15
마그네다리,43900,17,16,15,16,2,1
마그네사거리,43029,309,325,293,325,16,20
마그네사거리,43030,480,274,462,274,18,24
마니산상회,43417,140,25,126,25,14,5
마니산상회,43443,34,75,31,75,3,3
마니산입구,43102,236,714,230,714,6,30
마니산입구,43103,895,261,875,261,20,37
마당개,35681,99,88,90,88,9,6
마당개,35697,58,14,58,14,0,2
마린월드,70004,1119,156,1098,156,21,41
마린월드,70029,6,181,0,181,6,6
마미,43747,44,16,44,16,0,1
마미,43765,13,23,13,23,0,1
마송,80131,537,4784,528,4784,9,171
마송,80132,3375,757,3303,757,72,133
마시란,35424,75,598,75,598,0,21
마시란,35425,441,71,429,71,12,16
마시란해변(슈퍼앞),35262,0,14,0,14,0,0
마시란해변(슈퍼앞),35263,22,0,22,0,0,0
마시란해변(전주집),35260,0,3,0,3,0,0
마시란해변(전주집),35261,20,0,20,0,0,0
마시란해변승마장,35212,14,0,14,0,0,0
마시란해변승마장,35213,2,6,2,6,0,0
마을금고,40528,1844,5654,1760,5654,84,241
마을회관,43314,38,1,38,1,0,1
마을회관,43773,0,13,0,13,0,0
마을회관입구,35024,321,2571,257,2571,64,93
마을회관입구,35402,1505,106,1483,106,22,51
마장공원,40286,7293,26,7172,26,121,236
마장포,35679,27,5,26,5,1,1
마장포,35699,94,55,83,55,11,4
마장포고개,35677,54,28,54,28,0,2
마장포고개,35701,27,24,27,24,0,1
마전고등학교,42752,129,8660,98,8660,31,283
마전고등학교,42753,6458,259,6205,259,253,216
마전역,42412,3466,9001,3392,9001,74,402
마전역,42413,19804,5266,19534,5266,270,808
마전주공아파트,42420,25,141,12,141,13,5
마전주공아파트,89322,0,1,0,1,0,0
마전지구대원아파트,42481,4799,87,4668,87,131,157
마전지구대원아파트,89446,16,3463,16,3463,0,112
마전지구버스차고지,89259,4217,70,3906,70,311,138
마전지구버스차고지,89345,325,2374,69,2374,256,87
마전초등학교,42408,5951,5740,5850,5740,101,377
막촌,43460,245,19,226,19,19,8
막촌,43776,0,106,0,106,0,3
만석동행정복지센터,36046,4530,1929,4376,1929,154,208
만석부두,36076,390,3426,382,3426,8,123
만석부두,36079,4611,1557,4543,1557,68,198
만석비치타운,36106,574,9399,550,9399,24,321
만석비치타운,36126,1595,939,1447,939,148,81
만석삼거리,36185,2738,2500,2655,2500,83,168
만석삼거리,36186,1404,2242,1386,2242,18,117
만석어린이공원,36182,26,507,3,507,23,17
만석주공,36057,14786,2416,14446,2416,340,554
만석초등학교,36056,744,244,703,244,41,31
만석초등학교,36187,1,85,1,85,0,2
만수1동행정복지센터,39294,11546,5067,11402,5067,144,535
만수2동행정복지센터·포레시안,39731,16713,10173,16453,10173,260,867
만수2동행정복지센터·포레시안,39735,10181,11398,10082,11398,99,696
만수3동주민센터,39425,21287,29345,21042,29345,245,1633
만수3동주민센터,39427,34658,13903,34363,13903,295,1566
만수3동주민센터,39544,612,114,599,114,13,23
만수3동주민센터,39545,71,1047,65,1047,6,36
만수4동주민센터,39452,7073,7276,6937,7276,136,462
만수4동주민센터,39454,7120,12845,6999,12845,121,644
만수6동주민센터입구,39277,4506,12588,4468,12588,38,551
만수7.8단지앞,39497,950,2192,944,2192,6,101
만수7.8단지앞,39635,2716,2546,2650,2546,66,169
만수북중학교,39468,1132,1913,1106,1913,26,98
만수북중학교,39469,2256,602,2194,602,62,92
만수북초등학교,39420,7499,4946,7411,4946,88,401
만수소방서,39428,10068,18559,9946,18559,122,923
만수소방서,39433,40110,14582,39730,14582,380,1764
만수신동아아파트·동인천고,39485,11222,11313,10319,11313,903,726
만수신동아아파트·동인천고,39578,357,42,339,42,18,12
만수역,39385,3974,144,3971,144,3,132
만수역,39388,452,19683,404,19683,48,649
만수종합시장,39451,31403,10072,30597,10072,806,1337
만수종합시장,39592,9911,23260,9746,23260,165,1070
만수주공1단지,39401,3380,3088,3359,3088,21,208
만수주공320동앞,39431,1384,1687,1357,1687,27,99
만수주공4단지,39440,7310,5838,7215,5838,95,424
만수주공4단지,39443,10579,8216,10439,8216,140,606
만수주공정문,39408,11079,9187,10960,9187,119,653
만수주공정문,39410,3126,3472,3062,3472,64,212
만수주공후문,39429,4174,6014,4132,6014,42,328
만수주공후문,39435,1544,6994,1508,6994,36,275
만수주공후문,39438,14778,4030,14556,4030,222,606
만수중(대토단지),39400,367,1687,363,1687,4,66
만수중학교후문,39745,140,960,137,960,3,35
만수초등학교,39303,1617,5058,1549,5058,68,215
만수초등학교,39307,809,1003,767,1003,42,58
만수치안센터,39455,732,534,720,534,12,40
만월종합사회복지관,92065,6,1955,6,1955,0,63
만월중학교,39962,2454,368,2394,368,60,91
만월중학교,39963,94,2803,89,2803,5,93
만의골입구,39666,112,69,112,69,0,5
만의골입구,39672,23,312,21,312,2,10
만정낚시터,35682,54,24,49,24,5,2
만정낚시터,35696,7,32,7,32,0,1
만정낚시터입구,35683,27,31,27,31,0,1
만정낚시터입구,35695,16,21,16,21,0,1
망양돈대,90224,1,32,1,32,0,1
망양돈대,90225,30,7,28,7,2,1
망월3리,43332,217,111,203,111,14,10
망월3리,43580,0,38,0,38,0,1
망월입구,43117,13,0,13,0,0,0
망월입구,43576,104,58,100,58,4,5
망월입구,43790,63,55,54,55,9,3
망월종점,43788,8,13,6,13,2,0
매음1리마을회관,90173,23,37,23,37,0,1
매음1리마을회관,90174,20,6,19,6,1,0
매음3리마을회관(민머루),90321,3,21,3,21,0,0
매음3리마을회관(민머루),90322,8,1,6,1,2,0
매제미고개,43837,15,6,11,6,4,0
매제미고개,43988,20,48,19,48,1,2
먼우금사거리,38114,6602,3839,6558,3839,44,336
먼우금초등학교,38021,2998,11991,2846,11991,152,483
메이루즈커낼파크뷰,42747,3993,10392,3683,10392,310,464
메이루즈커낼파크뷰,42762,11376,3673,10992,3673,384,485
메이루즈커낼파크뷰정문,42794,4170,4155,4034,4155,136,268
메제미,43302,212,31,211,31,1,7
메제미,43598,6,218,6,218,0,7
면사무소입구,90018,36,262,30,262,6,9
면사무소입구,90019,135,23,127,23,8,5
면허시험장,39006,1859,1717,1838,1717,21,115
명가빌라(회차),37553,2336,2226,2188,2226,148,147
명보주택앞,43979,5,13,5,13,0,0
명보주택앞,43984,25,6,24,6,1,1
명신여자고등학교,40289,20168,5664,19772,5664,396,833
명신여자고등학교,40291,5922,12223,5753,12223,169,585
명신초등학교,43394,60,3,57,3,3,2
명신초등학교,43803,4,97,4,97,0,3
명진부페,43632,7,4,7,4,0,0
명현중학교,41405,2900,7656,2831,7656,69,340
명현초등학교,41559,5510,1457,5488,1457,22,224
명현초등학교,41560,1277,3898,1250,3898,27,166
명현초등학교(효성지구대),41069,857,2947,839,2947,18,122
모다아울렛,89190,3018,3080,2996,3080,22,196
모래내시장,39295,15347,14090,14972,14090,375,949
모래내시장,39298,13557,11007,13237,11007,320,792
모래내시장,39344,6378,6518,6378,6518,0,416
모래내시장,39350,11281,13026,11038,13026,243,784
모래내시장역(1번출구),39338,12225,9248,11954,9248,271,692
모래내시장역(2번출구),39909,9085,12524,8878,12524,207,697
모래내시장역(3번출구),39339,34120,30767,33681,30767,439,2093
모래내시장역(4번출구),39335,1765,6302,1725,6302,40,260
모래방죽사거리,89228,1463,923,1419,923,44,76
모래방죽사거리,89229,1470,3171,1432,3171,38,149
모름말,90255,28,1,24,1,4,0
모름말,90311,0,12,0,12,0,0
모리부락입구,90304,16,0,16,0,0,0
모아아파트,70033,260,731,260,731,0,31
모아아파트.세종프라자,70034,746,176,718,176,28,29
모현,43659,1,271,1,271,0,8
모현,43689,266,10,257,10,9,8
목개마을,90153,20,14,20,14,0,1
목개마을,90154,39,22,38,22,1,1
목너머,35863,23,3,22,3,1,0
목너머,35864,0,34,0,34,0,1
목련어린이집,40824,9192,3873,9081,3873,111,421
목비고개,43032,106,151,86,151,20,8
목비고개,43272,230,116,209,116,21,11
목상교입구,41493,30,4,28,4,2,1
목상교입구,41519,6,12,6,12,0,0
목상교차로,41636,4,265,4,265,0,8
목상교차로,41637,233,5,230,5,3,7
목상동(새봄농원입구),41323,0,88,0,88,0,2
목상동(새봄농원입구),41324,57,9,57,9,0,2
목상동마을입구,41318,1,237,1,237,0,7
목상동마을입구,41517,222,29,219,29,3,8
목상동솔밭.이주단지입구,41316,1866,45,1829,45,37,61
목상동솔밭.이주단지입구,41317,9,1168,3,1168,6,37
목장앞,43503,1,7,1,7,0,0
목장앞,43688,4,1,4,1,0,0
목재단지,42036,358,617,355,617,3,31
목재부두사거리,42949,2,376,2,376,0,12
목재부두사거리,42960,44,40,41,40,3,2
목화빌라,37545,6,373,4,373,2,12
목화예식장,39446,15990,12810,15711,12810,279,929
목화예식장,39448,15054,23231,14877,23231,177,1235
무내미마을,39496,692,952,683,952,9,53
무내미마을,40106,175,4420,163,4420,12,148
무의도입구,35001,8810,395,8715,395,95,296
무의도입구,35002,696,7692,662,7692,34,270
무의도주민자치센터,35738,458,96,454,96,4,17
무의도주민자치센터,35739,130,367,130,367,0,16
무지개.한양8차아파트,40271,6938,3550,6828,3550,110,338
무지개.한양8차아파트,40276,5684,9732,5582,9732,102,497
무지개아파트,38366,3652,2581,3499,2581,153,201
무지개아파트(동남아파트),38042,7456,1068,6910,1068,546,274
무학리입구,90276,51,37,51,37,0,2
묵골,43498,19,9,19,9,0,0
묵골,43684,8,19,3,19,5,0
문남마을,38250,9594,5351,9447,5351,147,482
문남초등학교,38214,2547,2602,2480,2602,67,166
문남초등학교,38216,2854,3954,2743,3954,111,219
문말3거리,44084,2,7,0,7,2,0
문말삼거리,44001,303,51,299,51,4,11
문말삼거리,44002,18,324,17,324,1,11
문산교회앞,43340,13,23,9,23,4,1
문산교회앞,43589,18,25,14,25,4,1
문산리마을회관,43101,108,435,89,435,19,17
문일여고·하우스토리만수아파트,39313,1310,4044,1287,4044,23,172
문일여고·하우스토리만수아파트,39314,5531,868,5392,868,139,206
문일여자고등학교후문,39685,2276,4094,2232,4094,44,205
문학경기장(X게임장),37643,106,203,81,203,25,9
문학경기장(박태환수영장),38310,3618,2479,3572,2479,46,196
문학경기장(박태환수영장),38311,1419,3954,1393,3954,26,173
문학경기장(박태환수영장),38329,1568,1319,1535,1319,33,93
문학경기장(박태환수영장),38423,875,2362,863,2362,12,104
문학경기장(야구장),37144,6587,12731,6211,12731,376,623
문학경기장(월드컵경기장),37157,5357,10600,5172,10600,185,514
문학경로당,37087,5460,3450,5375,3450,85,287
문학경로당,37088,4551,4053,4353,4053,198,277
문학고개,37056,3222,2507,3142,2507,80,184
문학고개,37057,2868,3759,2761,3759,107,213
문학고개,37101,2884,4371,2832,4371,52,234
문학우체국,37520,4383,5080,4219,5080,164,305
문학우체국,37521,6078,3373,5940,3373,138,304
문학정보고입구,37107,4677,6441,4547,6441,130,358
문학정보고입구,37108,6795,2560,6617,2560,178,301
문학초등학교,37105,22626,8770,22050,8770,576,1012
문학초등학교,37110,8868,16449,8626,16449,242,816
문현,43005,56,85,56,85,0,4
문현,43164,27,28,24,28,3,1
문현,43195,178,20,168,20,10,6
문현,43321,11,163,11,163,0,5
문화교회,40173,404,264,399,264,5,21
문화교회,40174,9833,10415,9625,10415,208,653
문화예술회관,39197,3805,6706,3764,6706,41,339
문화예술회관,39199,1052,716,1031,716,21,57
물류단지D블럭앞,35604,270,4,266,4,4,8
물류단지F블럭앞,35603,0,472,0,472,0,15
물왕TG(미정차),70223,3,0,3,0,0,0
미관광장,38508,4,107,1,107,3,3
미관광장,38512,8,10,8,10,0,0
미단교회사거리,35664,143,110,137,110,6,8
미단교회사거리,35665,5,28,5,28,0,1
미도아파트,37446,1182,1358,1178,1358,4,81
미도아파트,41027,11390,3435,11203,3435,187,478
미도아파트,41028,4291,10847,4203,10847,88,488
미래빌라,36088,6406,834,6260,834,146,233
미래빌라,36089,1388,4647,1369,4647,19,194
미래타운1.2단지,40683,4722,19126,4579,19126,143,769
미래타운1.2단지,40684,13622,3128,13470,3128,152,540
미래타운5단지,40672,1017,4331,1002,4331,15,172
미래타운5단지501동,40662,6159,297,6050,297,109,208
미래타운5단지505동,40669,7123,3275,6914,3275,209,335
미래테크원,92015,2298,788,2280,788,18,99
미루지,43420,26,15,23,15,3,1
미루지,43522,44,21,43,21,1,2
미륭아파트,36138,3579,534,3480,534,99,132
미륭아파트,36139,560,3103,529,3103,31,118
미림극장,36008,1602,7269,1511,7269,91,286
미림극장,36009,8738,2194,8498,2194,240,352
미림극장입구,36141,111,269,105,269,6,12
미산초등학교,40378,6951,10373,6805,10373,146,558
미송초등학교,38654,16403,1049,15867,1049,536,562
미송초등학교(하행),38653,2039,9337,1929,9337,110,366
미주탕,42123,3212,11121,3173,11121,39,462
미주탕,42124,11463,5500,11208,5500,255,547
미추홀경찰서(장미아파트),37524,906,3917,870,3917,36,155
미추홀공원,38368,7913,2812,7681,2812,232,345
미추홀구청,37304,4607,3813,4463,3813,144,271
미추홀구청,37307,677,2466,667,2466,10,101
미추홀구청입구,37306,9300,17729,9192,17729,108,871
미추홀구청입구,37312,10089,11773,9860,11773,229,705
미추홀구평생학습관,37073,6601,6455,6485,6455,116,421
미추홀도서관·인천신월초등학교,39270,4083,8851,3986,8851,97,417
미추홀아파트,40250,123,399,121,399,2,16
미추홀아파트,40254,238,265,235,265,3,16
미추홀외고,39689,599,933,541,933,58,49
미추홀외고,39690,862,377,813,377,49,39
미추홀퍼스트(2단지),37220,9092,3268,8869,3268,223,398
미추홀퍼스트(2단지),37642,3404,8978,3319,8978,85,399
미추홀퍼스트2단지,37646,2487,406,2449,406,38,93
미추홀퍼스트3단지,37647,600,2839,590,2839,10,110
민머루해수욕장,90336,13,13,13,13,0,0
민방위교육장,38610,138,324,138,324,0,14
민방위교육장,38611,518,430,512,430,6,30
민방위교육장,39733,8228,2490,8108,2490,120,345
민방위교육장,39734,85,2691,66,2691,19,89
민방위교육장입구,41043,2197,5739,2110,5739,87,256
바로크아파트,42530,884,516,859,516,25,45
박공현,43228,47,3,38,3,9,1
박공현,43294,4,32,3,32,1,1
박문여자고등학교,39799,1045,211,946,211,99,40
박문여자고등학교,39800,398,570,368,570,30,31
박문중학교,39844,622,239,581,239,41,27
박문중학교,39847,408,3026,400,3026,8,110
박문중학교정문,39860,3432,286,3318,286,114,119
박문중학교후문,39859,289,62,274,62,15,11
박물관앞,43668,26,167,24,167,2,6
박물관앞,43698,242,43,221,43,21,9
박촌마을입구,35670,158,7,139,7,19,5
박촌마을입구,35671,4,223,4,223,0,7
박촌역,41309,18706,24657,18273,24657,433,1398
박촌역,41310,18696,12409,18506,12409,190,1003
반달마을.법원.검찰청,55014,1577,4142,1554,4142,23,184
반도유보라,42904,619,2574,578,2574,41,103
반도유보라,42905,3029,478,2911,478,118,113
반도유보라,42963,2166,855,2090,855,76,97
반도유보라,42985,3269,1534,3184,1534,85,154
반디모텔,44126,9,0,9,0,0,0
반디모텔,44170,0,1,0,1,0,0
반찬단지,89426,216,258,213,258,3,15
반찬단지,89427,447,63,440,63,7,16
반포역,31034,176,3813,176,3813,0,128
반포역,31035,6135,146,6135,146,0,202
발산초등학교(풍림아이원),42433,273,158,269,158,4,13
발전소삼거리,44115,76,120,65,120,11,6
발전소삼거리,44171,2,0,2,0,0,0
밝게,43990,6,0,6,0,0,0
밝게,43991,0,9,0,9,0,0
밤나무골,43022,81,99,68,99,13,5
밤나무골,43023,136,78,133,78,3,6
방개마을,90141,35,19,34,19,1,1
방개마을,90142,0,18,0,18,0,0
방아머리,62008,320,53,300,53,20,12
방아머리,62032,34,175,33,175,1,6
방아머리선착장,62007,35,434,35,434,0,15
방아머리제1주차장,62031,46,309,46,309,0,11
방아머리제1주차장,62041,585,71,572,71,13,21
방죽골,39763,2478,2986,2393,2986,85,176
방죽골,39764,1543,3157,1500,3157,43,151
방죽말,43027,71,141,69,141,2,6
방죽말,43214,23,120,20,120,3,4
방죽삼거리,39173,349,1222,341,1222,8,50
방죽삼거리,39174,765,468,735,468,30,39
방죽삼거리,42681,1734,651,1703,651,31,76
방죽삼거리,42683,461,1193,449,1193,12,53
방촌공원,40419,2307,2894,2286,2894,21,167
방축삼거리,36159,587,457,584,457,3,33
방파제입구,35048,1,969,1,969,0,31
방화동도시개발11단지,25026,997,65,965,65,32,34
방화중학교,25008,5048,123,5014,123,34,166
방화중학교,25009,39,1262,39,1262,0,41
배다리,35186,10893,19904,10733,19904,160,993
배다리삼거리,36006,12301,8921,11914,8921,387,684
배다리삼거리,36007,7503,8815,7246,8815,257,526
배다리성냥마을박물관,36167,4,20,4,20,0,0
배다리청과물시장,35184,4426,2774,4327,2774,99,232
배다리헌책방거리,36158,434,676,399,676,35,35
배수지입구,42774,691,128,651,128,40,26
백두아파트,42632,9086,4256,8891,4256,195,430
백련사입구,43419,23,71,22,71,1,3
백련사입구,43808,34,4,33,4,1,1
백련산입구,35773,6,1,6,1,0,0
백련산입구,35778,0,22,0,22,0,0
백마장입구,40389,10900,2837,10750,2837,150,443
백마장입구,40390,2576,9980,2530,9980,46,405
백마장입구,40399,18999,19303,18685,19303,314,1235
백마장입구,40407,8987,9621,8792,9621,195,600
백병원(송림패션몰),36151,408,102,393,102,15,16
백사장회센터,62033,12,160,11,160,1,5
백사장회센터,62039,200,28,188,28,12,7
백산아파트,38112,3489,4473,3263,4473,226,256
백산아파트,38113,3730,4521,3645,4521,85,266
백산아파트,38328,2004,1587,1935,1587,69,115
백석고가(하이마트),42381,3980,3116,3864,3116,116,228
백석고가(하이마트),42578,4079,3850,3906,3850,173,255
백석마을,35096,0,12,0,12,0,0
백석중.고등학교,42374,6644,3705,6392,3705,252,333
백석중.고등학교,42375,3908,6412,3774,6412,134,332
백석중사거리,89238,11,69,11,69,0,2
백석중사거리,89239,69,352,33,352,36,13
백승아파트,41383,94,461,83,461,11,17
백승아파트,41384,144,325,143,325,1,15
백암왕순대앞,38483,2119,1782,2064,1782,55,125
백영아파트,40058,9097,4906,8820,4906,277,451
백영아파트,41361,8301,135,8219,135,82,272
백운곡,43040,211,92,196,92,15,9
백운곡,43295,70,237,64,237,6,9
백운공원,40072,14,700,5,700,9,23
백운공원(부평아트센터),40075,791,4819,780,4819,11,180
백운공원(부평아트센터),40076,3444,1310,3336,1310,108,153
백운역,40079,15765,22916,15494,22916,271,1247
백운역,40080,26672,22353,26493,22353,179,1581
백운역,40081,62066,54931,61566,54931,500,3774
백운역,40716,12195,3164,11980,3164,215,495
백운역(파출소),40094,108,1965,104,1965,4,66
백운역(하행),40901,2402,8863,2364,8863,38,363
백운프라자,37181,4429,10403,4269,10403,160,478
백운프라자,37185,7875,4241,7724,4241,151,390
백조아파트,40386,306,695,303,695,3,32
백조아파트,40388,1601,706,1533,706,68,74
뱃말항,44125,2,0,2,0,0,0
뱃말항,44172,0,2,0,2,0,0
뱅뱅사거리,31012,9,2133,9,2133,0,69
뱅뱅사거리,32001,2326,23,2325,23,1,75
버드러지,43428,14,20,14,20,0,1
버드러지,43476,109,28,96,28,13,4
번영로제1사거리,39113,327,1281,325,1281,2,51
번영로제3사거리,39036,1044,207,1039,207,5,40
번영로제3사거리,39037,214,1322,196,1322,18,49
벌말,43175,5,40,5,40,0,1
벌말,43297,79,2,77,2,2,2
벌판마을입구,35763,9,110,9,110,0,3
벌판마을입구,35764,93,54,92,54,1,4
범양상가,42118,4714,11491,4670,11491,44,522
범양상가,42122,10815,2452,10667,2452,148,427
범양아파트,42116,8920,2911,8740,2911,180,381
범양아파트(종점),42127,144,3,141,3,3,4
범허리종점,43974,86,68,78,68,8,4
법원,37130,262,1890,256,1890,6,69
법원,37131,1861,981,1833,981,28,91
법원.검찰청,37074,8334,5877,8173,5877,161,458
법원.검찰청.복사골문화센터.반달마을,55020,4187,2623,4111,2623,76,219
법원검찰청입구,37078,3632,4384,3536,4384,96,258
베어즈베스트골프장,89268,425,1282,424,1282,1,55
베어즈베스트골프장,89269,500,3341,500,3341,0,123
베어즈베스트청라GC,89046,64,162,64,162,0,7
베어즈베스트청라GC,89047,50,326,50,326,0,12
벧엘교회,39740,217,1524,168,1524,49,56
벽산.이삭아파트,39453,21986,28195,21797,28195,189,1618
벽산1차아파트,70023,141,1770,133,1770,8,61
벽산1차아파트,70024,2310,178,2242,178,68,80
벽산아파트,39459,2166,54,2127,54,39,71
벽산아파트,39549,22,3727,16,3727,6,120
벽산아파트(미추홀도서관),39273,13570,4260,13357,4260,213,575
벽산이삭아파트,39458,21780,13931,21547,13931,233,1151
별립산입구,43588,3,132,3,132,0,4
별립산입구,43778,65,0,59,0,6,2
병무청(학익풍림아이원),37013,40,24,33,24,7,2
병무청(학익풍림아이원),37671,24,1082,24,1082,0,35
병방사거리,41301,438,3055,422,3055,16,112
병방사거리,41303,6272,2081,6129,2081,143,269
병방초등학교,41302,652,996,646,996,6,53
병방초등학교,41304,1571,1236,1537,1236,34,90
병방초등학교(계양산전통시장),41299,18782,14470,18440,14470,342,1072
보건소,43318,2,3,2,3,0,0
보건소,43626,1,52,0,52,1,1
보건환경연구원,35158,2300,2330,2232,2330,68,149
보람프라자앞,42442,29227,17991,28922,17991,305,1523
보릿고개,43517,43,485,43,485,0,17
보릿고개,43880,348,109,330,109,18,14
보무기,90165,33,98,33,98,0,4
보무기,90166,61,22,59,22,2,2
보문사,90206,2444,2060,2342,2060,102,145
보트비,89424,43,273,41,273,2,10
보트비,89425,158,57,158,57,0,6
보훈회관,39484,5692,9125,5559,9125,133,477
복사골문화센터.한아름마을,55026,2229,4118,2213,4118,16,204
복지회관,38079,2100,1289,2073,1289,27,109
복지회관,38080,1035,3645,985,3645,50,150
본향교회,39164,13789,2788,13468,2788,321,534
볼보트럭남인천사업소,35814,620,863,610,863,10,47
봉골,43535,26,10,23,10,3,1
봉골,43673,8,31,8,31,0,1
봉성(오상2리),43261,2,83,2,83,0,2
봉성(오상2리),43377,98,0,85,0,13,3
봉소리마을회관,43000,68,15,63,15,5,2
봉소리마을회관,90001,16,52,13,52,3,2
봉수초등학교,42980,71,423,71,423,0,15
봉수초등학교,42981,94,926,93,926,1,32
봉수파출소,42982,1077,1795,1067,1795,10,92
부개1동행정복지센터,40191,2950,6686,2900,6686,50,310
부개1동행정복지센터,40193,8043,5013,7861,5013,182,421
부개2동행정복지센터,40323,1779,524,1753,524,26,74
부개2파출소,40317,371,257,357,257,14,20
부개2파출소,40318,3390,5170,3244,5170,146,276
부개2파출소,40329,4785,1762,4685,1762,100,211
부개2파출소,40764,91,207,89,207,2,9
부개3동행정복지센터,40494,1556,271,1533,271,23,58
부개3동행정복지센터입구,40486,169,1396,158,1396,11,50
부개6단지후문.웅진플레이,55021,58,2404,52,2404,6,79
부개고입구,40345,4054,5021,3899,5021,155,292
부개고입구,40783,6510,2844,6380,2844,130,301
부개농협,40199,504,2528,464,2528,40,97
부개농협,40201,2762,1006,2649,1006,113,121
부개서초등학교,40243,1685,763,1634,763,51,78
부개성일아파트,40293,7708,3565,7530,3565,178,363
부개성일아파트,40301,5865,11308,5620,11308,245,553
부개여자고등학교,40421,3101,1364,3086,1364,15,144
부개여자고등학교,40422,2161,2266,2088,2266,73,142
부개여자고등학교,40423,9252,5183,9110,5183,142,465
부개여자고등학교,40428,3843,5774,3779,5774,64,310
부개역,40222,2358,9877,2231,9877,127,394
부개역,40223,8081,3971,7847,3971,234,388
부개역,40256,37164,20930,36276,20930,888,1874
부개우체국,40458,10416,6642,10251,6642,165,550
부개종합시장,40504,8971,3944,8801,3944,170,416
부개주공2단지,40772,501,650,490,650,11,37
부개주공3단지,40479,3402,1123,3380,1123,22,145
부개주공3단지정문,40460,330,830,328,830,2,37
부개주공3단지후문,40500,3802,6192,3746,6192,56,322
부개주공6단지,40442,3840,2475,3756,2475,84,203
부개주공6단지,40459,3763,4393,3739,4393,24,263
부개주공7단지,40385,8292,3303,8187,3303,105,374
부개주공7단지,40387,3510,5798,3485,5798,25,300
부광여자고등학교,40471,490,1719,469,1719,21,71
부광초등학교,40434,1291,4046,1273,4046,18,172
부광초등학교,40440,5444,2065,5303,2065,141,242
부근삼거리,43586,693,97,648,97,45,25
부근삼거리,43652,240,613,225,613,15,27
부대아래,90106,5,5,5,5,0,0
부대아래,90107,12,1,11,1,1,0
부대앞,18392,171,2,164,2,7,5
부대앞,18397,2,79,2,79,0,2
부대앞,38594,168,294,166,294,2,14
부대앞,41321,133,559,124,559,9,22
부대앞,41322,329,1016,327,1016,2,43
부대앞,41531,6,65,6,65,0,2
부대앞,41532,59,38,58,38,1,3
부대앞,42342,212,641,208,641,4,27
부대앞,42343,69,243,69,243,0,10
부대앞,43435,63,30,63,30,0,3
부대앞,43787,73,28,66,28,7,3
부동산입구,38278,2686,1413,2655,1413,31,132
부동산입구,38743,172,606,172,606,0,25
부명고.순천향대학병원,55036,1902,6261,1885,6261,17,263
부원여중·동아아파트,40202,7003,2054,6784,2054,219,292
부원여중·동아아파트,40208,1183,5878,1158,5878,25,227
부원중학교,40181,27057,16708,26236,16708,821,1411
부원중학교,40789,11577,29151,11306,29151,271,1313
부일여자중학교,40123,15948,2666,15782,2666,166,600
부천IC,57023,2692,2744,2676,2744,16,175
부천IC,57025,4217,2814,4194,2814,23,226
부천시청역1번출구,55061,2902,983,2901,983,1,125
부천시청역2번출구.현대백화점.이마트,55054,18754,8217,18523,8217,231,870
부천시청역3번출구.경기예고.현대백화점,55057,8754,11033,8723,11033,31,638
부천시청역4번출구.현대백화점.경기예고,55059,10052,7676,9974,7676,78,571
부천시청역5번출구,55060,1554,5343,1552,5343,2,222
부천실내체육관,55075,982,1756,969,1756,13,88
부천오정물류단지(중),57042,422,788,416,788,6,39
부천오정물류단지(중),57043,527,828,527,828,0,43
부천자동차검사소,57017,1046,1838,1043,1838,3,93
부천자동차검사소,57041,1587,1670,1557,1670,30,105
부천터미널소풍,55051,2359,8902,2341,8902,18,363
부천테크노파크1.2단지,57001,1793,2477,1785,2477,8,137
부천테크노파크1단지,57003,2297,2354,2285,2354,12,150
부평2동행정복지센터,40744,292,1113,286,1113,6,45
부평4동성당,40377,3459,2524,3357,2524,102,193
부평6동우체국,40186,1351,465,1297,465,54,58
부평6동행정복지센터,40906,5560,203,5335,203,225,185
부평LH1(2)단지,40160,6976,7822,6868,7822,108,477
부평LH1(2)단지,40161,5160,4623,5041,4623,119,315
부평SKVIEW해모로아파트,40282,521,484,502,484,19,32
부평SKVIEW해모로아파트,40285,709,750,706,750,3,47
부평감리교회,40148,1274,646,1219,646,55,61
부평경찰서,40468,49455,17263,49160,17263,295,2152
부평경찰서,40794,14296,41968,14194,41968,102,1814
부평구보건소,40372,5959,2009,5735,2009,224,257
부평구보건소,40373,2443,6760,2414,6760,29,296
부평구보건소,40858,2245,2255,2194,2255,51,145
부평구보건소,40890,3478,3891,3434,3891,44,237
부평구자활센터,40651,22448,2059,21769,2059,679,790
부평구자활센터,40658,432,12066,417,12066,15,403
부평구청,40462,36726,27933,36401,27933,325,2085
부평구청,40482,7004,4940,6934,4940,70,385
부평구청,40484,4373,5216,4314,5216,59,309
부평구청,40492,5002,17730,4944,17730,58,733
부평구청·부평세무서,40451,31009,40113,30698,40113,311,2294
부평구청역,40841,21312,4684,21195,4684,117,838
부평기적의도서관,40497,7056,3736,6883,3736,173,348
부평기적의도서관.삼부한신아파트,40490,3330,3783,3286,3783,44,229
부평남부역,40169,3620,5712,3581,5712,39,301
부평남부역입구,40170,6962,3015,6826,3015,136,321
부평남초등학교,40141,3962,2455,3807,2455,155,207
부평남초등학교앞,40136,2657,3885,2588,3885,69,211
부평농장,39772,200,923,198,923,2,36
부평농장사무소,39483,1656,2326,1623,2326,33,128
부평농장의원입구,39494,283,652,280,652,3,30
부평도서관,40082,1532,3011,1505,3011,27,146
부평도서관,40084,1759,2680,1659,2680,100,143
부평동중,40406,3125,2644,3088,2644,37,186
부평동중,55009,3123,2654,3051,2654,72,186
부평래미안아파트,40437,2365,3706,2320,3706,45,195
부평래미안아파트,40438,6301,2116,6140,2116,161,271
부평북초등학교,40656,1702,535,1631,535,71,72
부평북초등학교,40657,727,3715,702,3715,25,143
부평사거리,40073,2719,6110,2663,6110,56,284
부평사거리,40074,13093,8331,12862,8331,231,691
부평사거리,40887,1532,5665,1423,5665,109,232
부평삼거리,39489,12659,10735,12448,10735,211,754
부평삼거리역,39491,5313,2329,5233,2329,80,246
부평삼거리역,40066,13048,10526,12831,10526,217,760
부평샬레아파트(세일고등학교),40260,2014,8184,1972,8184,42,328
부평샬레아파트(세일고등학교),40263,5937,2269,5777,2269,160,264
부평서중,40092,694,725,667,725,27,45
부평서중,40095,349,764,341,764,8,35
부평시장,40262,64484,30460,63296,30460,1188,3062
부평시장,40264,25534,41769,25139,41769,395,2171
부평시장,40265,14205,7439,13834,7439,371,698
부평시장,40283,19130,11301,18730,11301,400,981
부평시장,40290,10899,8787,10655,8787,244,635
부평시장(가구의거리),40295,31041,26200,29748,26200,1293,1846
부평시장(가구의거리),40296,35428,10582,34373,10582,1055,1484
부평시장(당약국),40303,1308,1319,1298,1319,10,84
부평시장(용갈비),40344,6870,497,6545,497,325,237
부평시장(한남프라자),40259,16655,11111,16127,11111,528,895
부평시장(한라비발디),40328,5883,2339,5675,2339,208,265
부평시장(한라비발디),40336,9488,16852,9362,16852,126,849
부평시장역,40361,19051,56185,18708,56185,343,2426
부평시장역(부평대로우체국),40368,39368,15782,38841,15782,527,1779
부평시장입구,40288,5153,10024,5057,10024,96,489
부평시장입구(2번출구),40309,9544,10995,9260,10995,284,662
부평아트센터,40078,2277,1371,2232,1371,45,117
부평아트센터,40709,1525,3200,1493,3200,32,152
부평여자고등학교,40365,3500,1424,3437,1424,63,158
부평여자고등학교,40410,7091,7510,6938,7510,153,471
부평여자고등학교,40793,8552,8486,8396,8486,156,549
부평여자중학교,40342,258,490,252,490,6,24
부평여자중학교,40726,256,432,251,432,5,22
부평역,40190,9471,47860,9299,47860,172,1849
부평역,40209,62136,59657,61096,59657,1040,3928
부평역,40226,26694,18226,26375,18226,319,1449
부평역,40228,42112,41923,41318,41923,794,2710
부평역,40234,17929,45820,17596,45820,333,2056
부평역,40237,15741,6162,15491,6162,250,706
부평역,40239,10465,10416,10299,10416,166,673
부평역(12번출구),40781,37870,70827,37121,70827,749,3506
부평역(27번출구),40224,41117,7534,40649,7534,468,1569
부평역(CU편의점),40192,40219,4040,39675,4040,544,1427
부평역(대한극장),40196,15768,59159,15560,59159,208,2417
부평역(로터스프라자),40246,20735,28982,20224,28982,511,1603
부평역(북인천우체국),40197,52699,34250,51908,34250,791,2804
부평역사박물관,40597,152,530,144,530,8,22
부평역사박물관,40609,808,174,776,174,32,31
부평역사박물관,40798,501,108,488,108,13,19
부평역화성파크드림아파트,40804,1090,3270,1044,3270,46,140
부평역화성파크드림아파트,40805,4848,1300,4670,1300,178,198
부평우체국,40430,4081,4455,4038,4455,43,275
부평우체국,40432,5716,4569,5626,4569,90,331
부평우체국,40443,351,173,337,173,14,16
부평윤산부인과,40478,504,425,472,425,32,29
부평윤산부인과,40768,430,1818,419,1818,11,72
부평자이,40871,156,1034,156,1034,0,38
부평정수장,40647,1705,3189,1691,3189,14,157
부평제이타워3차지식산업센터,40644,4090,2941,4056,2941,34,226
부평중앙침례교회,40481,158,1269,145,1269,13,46
부평중학교,40402,3804,3976,3615,3976,189,250
부평중학교,40416,3803,3683,3733,3683,70,241
부평코오롱아파트106동,40404,556,1087,544,1087,12,53
부평코오롱하늘채아파트,40357,709,696,702,696,7,45
부평코오롱하늘채아파트,40360,1206,812,1182,812,24,65
부평테크노타워,40615,2326,1422,2310,1422,16,120
부평테크노타워,40616,2163,3686,2130,3686,33,188
부현동초등학교,41175,12520,4543,12267,4543,253,550
부흥로터리,40412,1767,3412,1751,3412,16,167
부흥오거리(부흥아파트),40392,5667,5686,5539,5686,128,366
부흥오거리(부흥아파트),40394,7086,4138,7003,4138,83,362
부흥오거리(소망병원),40374,5708,9431,5535,9431,173,488
부흥오거리(소망병원),40375,15881,10282,15582,10282,299,843
부흥초교,40302,9097,2687,9007,2687,90,380
부흥초등학교,40299,4600,8143,4522,8143,78,411
부흥초등학교,40304,11095,5617,10944,5617,151,539
부흥초등학교·굿케어요양병원,40878,3938,6000,3907,6000,31,320
북구도서관,40469,3206,2728,3094,2728,112,191
북동삼거리,62001,514,71,500,71,14,18
북동삼거리,62002,68,582,66,582,2,20
북변환승센터.구터미널,80080,637,116,630,116,7,24
북변환승센터.구터미널,80081,4,110,0,110,4,3
북성교회,43744,53,17,51,17,2,2
북성교회,43764,15,12,14,12,1,0
북성마을,43136,172,19,157,19,15,6
북성마을,43528,41,95,41,95,0,4
북인천여자중학교,41007,8229,5260,8058,5260,171,435
북인천여자중학교,41008,6092,7041,6033,7041,59,423
북인천여자중학교,41015,942,15624,921,15624,21,534
북인천여자중학교,41016,8599,399,8414,399,185,290
북항다목적부두,89208,44,1671,35,1671,9,55
북항다목적부두,89209,1243,35,1212,35,31,41
북항배후단지입구,89343,37,766,35,766,2,25
북항배후로입구,89414,12,114,0,114,12,4
북항사업소,89210,5,1157,5,1157,0,37
북항사업소,89211,1476,21,1461,21,15,48
북항입구,89304,211,1103,203,1103,8,42
북항입구,89305,228,112,228,112,0,10
분오리어판장,43406,60,41,59,41,1,3
분오리어판장,43495,5,65,4,65,1,2
분오저수지,43493,6,10,6,10,0,0
분오저수지,43509,33,3,28,3,5,1
불로대곡동행정복지센터,42497,1076,1140,1049,1140,27,71
불로대곡동행정복지센터,42498,959,2241,933,2241,26,103
불로중학교,42648,298,1500,261,1500,37,58
불로중학교,42652,768,242,738,242,30,32
불은면주민센터,43035,816,445,790,445,26,40
불은초등학교,43293,87,1,83,1,4,2
불은초등학교,43530,16,39,15,39,1,1
불은파출소,43036,478,741,429,741,49,39
붉은노리삼거리,44112,165,184,147,184,18,11
붉은노리삼거리,44173,21,3,19,3,2,0
뷰티풀파크관리공단,42805,79,1,63,1,16,2
뷰티풀파크관리공단,42806,22,86,10,86,12,3
뷰티풀파크버스공영차고지,42803,175,1020,82,1020,93,38
뷰티풀파크버스공영차고지,42804,2794,52,2655,52,139,91
브라운스톤.엠코타운아파트,40659,12758,16800,12557,16800,201,953
블랙트리캠핑장,44124,19,28,18,28,1,1
블랙트리캠핑장,44174,31,0,29,0,2,1
블루오션골프클럽(앰코코리아),39879,20,788,18,788,2,26
비류마을,38261,1595,1540,1535,1540,60,101
비선삼거리,43113,0,4,0,4,0,0
비선삼거리,43114,24,11,23,11,1,1
비선삼거리,43547,434,534,407,534,27,31
비선삼거리,43596,227,112,221,112,6,10
비재고개,35420,266,63,249,63,17,10
비재고개,35421,49,229,48,229,1,8
비젼교회,40171,3177,2268,3068,2268,109,175
빈정공원,42571,1725,908,1698,908,27,84
빈정공원,42670,561,1243,550,1243,11,58
빈정내사거리,42327,1914,3071,1832,3071,82,160
빈정내사거리,42329,767,431,764,431,3,38
사랑마을벽산.선경.삼익아파트,55030,2948,2337,2947,2337,1,170
사리울삼거리,39128,3433,5962,3272,5962,161,303
사리울삼거리,39131,3096,2186,2985,2186,111,170
사리울중학교,39838,1699,5185,1610,5185,89,222
사리울중학교,39924,7413,1676,6866,1676,547,293
사리울초등학교후문,39713,5763,765,5430,765,333,210
사슴농장,43531,98,1,83,1,15,3
사슴농장,43866,0,46,0,46,0,1
사시미재,35731,86,19,83,19,3,3
사시미재,35732,58,169,58,169,0,7
사업.행정지원센터,35607,398,9,396,9,2,13
사업.행정지원센터,35608,17,512,17,512,0,17
사염공원,89037,3,167,3,167,0,5
사염공원,89038,63,3,63,3,0,2
사우고.김포고(걸포사거리방면),80064,4,686,4,686,0,22
사우고.김포시청,80024,122,3088,122,3088,0,103
사우고교.김포시청(직행),80377,1316,117,1314,117,2,46
사우역.김포고(김포초교방면),80380,885,4030,884,4030,1,158
사우역.김포고(직행),80043,623,9,622,9,1,20
사우역.김포고(직행),80376,3591,440,3586,440,5,130
사원아파트입구,42777,134,98,110,98,24,7
사일로벽화,35163,56,4389,52,4389,4,143
사일로벽화,35167,1866,278,1816,278,50,69
사조해표,42019,2069,1759,2026,1759,43,123
사조해표,42020,655,1170,642,1170,13,58
사직(해나무),43416,2,63,2,63,0,2
사직(해나무),43797,68,1,59,1,9,2
사촌,43597,74,0,65,0,9,2
사촌,43785,0,7,0,7,0,0
삭은다리한국지엠,40524,145,3263,138,3263,7,109
삭은다리한국지엠,40525,4077,1871,4048,1871,29,191
산곡3동행정복지센터,40156,3555,748,3493,748,62,138
산곡교회,40383,9028,2832,8853,2832,175,382
산곡남초등학교,40227,2155,53,2096,53,59,71
산곡동입구(롯데마트),40779,1307,1483,1286,1483,21,90
산곡동입구(롯데마트),40785,13456,23046,13243,23046,213,1177
산곡동주안빌딩,40313,13699,2036,13580,2036,119,507
산곡동천주교회,40473,23420,12814,22998,12814,422,1168
산곡동천주교회,40476,9862,21915,9543,21915,319,1025
산곡여자중학교,40198,7695,7771,7492,7771,203,498
산곡여자중학교,40203,2670,4468,2599,4468,71,230
산곡여자중학교,40215,39,2006,34,2006,5,65
산곡여자중학교,40216,5276,104,5164,104,112,173
산곡여자중학교(마장로삼거리),40911,1331,1360,1204,1360,127,86
산곡역(1번출구),40420,4881,19578,4780,19578,101,789
산곡역(3번출구),40856,6014,6041,5899,6041,115,388
산곡역(6번출구),40429,10658,16036,10503,16036,155,861
산곡역(7번출구),40425,38717,30539,38500,30539,217,2234
산곡중학교,40320,469,148,454,148,15,19
산곡중학교,40322,157,1693,155,1693,2,59
산곡한양7차,40354,117,9653,112,9653,5,315
산뒤,43235,45,141,39,141,6,6
산뒤,43887,139,20,138,20,1,5
산림조합앞,90234,23,41,20,41,3,2
산림조합앞,90235,19,126,19,126,0,4
산마루집,41497,29,77,29,77,0,3
산마루집,41513,62,2,62,2,0,2
산마을고등학교,43116,0,10,0,10,0,0
산마을고등학교,43599,6,2,6,2,0,0
산문입구,43107,199,208,192,208,7,13
산문입구,43286,285,265,276,265,9,17
산문입구,43899,22,1,21,1,1,0
산문종점,43154,35,102,34,102,1,4
산애들애,43143,9,10,9,10,0,0
산애들애,43492,11,3,11,3,0,0
산업단지사거리,36095,86,3841,76,3841,10,126
산업단지사거리,37460,6907,447,6784,447,123,237
산업용품센타,42524,6439,567,6394,567,45,226
산업용품센타,42525,52,2869,31,2869,21,94
산업용품유통센타23동,36096,315,2117,303,2117,12,78
산업용품유통센타31동,36097,135,1892,133,1892,2,65
산업용품유통센타39동,36099,217,1960,212,1960,5,70
산업용품유통센터,36156,746,5,731,5,15,24
산업용품유통센터1동,36146,2244,288,2235,288,9,81
산업용품유통센터39동,36157,39,2,39,2,0,1
산업용품유통센터C동,36101,1992,52,1949,52,43,65
산우리고개,43337,0,15,0,15,0,0
산우리고개,43850,19,0,19,0,0,0
산음입구,80004,5,463,4,463,1,15
산음입구,80005,119,20,81,20,38,4
산촌마을,43217,6,3,6,3,0,0
산촌마을,43308,28,16,26,16,2,1
산호아파트앞,80059,1933,242,1932,242,1,70
산화고개,43271,161,5,151,5,10,5
산화고개,43388,13,179,13,179,0,6
삼덕아파트,37403,717,935,712,935,5,53
삼덕아파트,37404,680,1033,664,1033,16,55
삼동암리마을회관,43169,1,20,0,20,1,0
삼동암리마을회관,43227,20,0,20,0,0,0
삼두2차아파트,36051,4176,857,4075,857,101,162
삼라마이다스아파트,89317,145,8,145,8,0,4
삼라마이다스아파트,89323,5,99,4,99,1,3
삼목사거리,35088,15,32,15,32,0,1
삼목선착장,35311,2163,2676,2112,2676,51,156
삼목선착장(운서역행),35077,2011,64,1945,64,66,66
삼목선착장입구,35058,0,24,0,24,0,0
삼목선착장입구,35059,5,6,3,6,2,0
삼목초등학교,35310,1007,1365,1007,1365,0,76
삼목초등학교,35341,2768,1057,2599,1057,169,123
삼미시장,70172,671,3091,641,3091,30,121
삼미시장,70173,2985,664,2958,664,27,117
삼미타운.e편한세상아파트,40172,5721,5475,5580,5475,141,361
삼보새마을금고,40796,6707,676,6627,676,80,238
삼보아파트,40298,2530,108,2509,108,21,85
삼보아파트,40308,11713,4699,11524,4699,189,529
삼보아파트,40677,8134,401,8035,401,99,275
삼보아파트,40679,498,7134,470,7134,28,246
삼보아파트,40786,4983,17168,4887,17168,96,714
삼보아파트,42350,2944,5988,2866,5988,78,288
삼보아파트,42351,7165,2187,7010,2187,155,301
삼보아파트(계양구청),41205,3985,8818,3906,8818,79,413
삼산경찰서,40584,989,2769,968,2769,21,121
삼산경찰서,40766,1909,3257,1888,3257,21,166
삼산고등학교(미래타운3단지),40689,11836,3277,11682,3277,154,487
삼산고등학교(미래타운4단지),40686,6146,8643,6021,8643,125,477
삼산군립어린이집,90171,21,27,20,27,1,1
삼산군립어린이집,90172,24,5,20,5,4,0
삼산글로리병원,40527,7755,7622,7651,7622,104,496
삼산농산물시장,40687,2492,4639,2380,4639,112,230
삼산동차고지,40830,311,17,196,17,115,10
삼산면사무소,90149,33,72,32,72,1,3
삼산면사무소,90150,116,85,111,85,5,6
삼산사거리,40638,6268,10489,6190,10489,78,540
삼산사거리,40690,3248,732,3192,732,56,128
삼산사거리,40691,4960,4277,4857,4277,103,297
삼산사거리(한국아파트),40646,3952,14728,3798,14728,154,602
삼산사거리.한국아파트,40645,6403,1543,6274,1543,129,256
삼산새마을금고,40668,582,7308,553,7308,29,254
삼산서해그랑블,40589,1693,1881,1639,1881,54,115
삼산서해아파트,40613,3197,756,3121,756,76,127
삼산월드체육관,40532,8640,3162,8579,3162,61,380
삼산월드체육관,40535,1462,1415,1449,1415,13,92
삼산월드체육관,40543,77,4551,77,4551,0,149
삼산월드체육관,40571,2482,2664,2384,2664,98,166
삼산월드체육관(삼산주공6단지),40802,1035,2464,1010,2464,25,112
삼산저수지앞,90245,14,2,14,2,0,0
삼산저수지앞,90246,2,2,2,2,0,0
삼산주공1단지,40780,1783,30,1740,30,43,58
삼산주공1단지(상가앞),40908,8044,626,7833,626,211,279
삼산주공4단지,40591,917,1890,903,1890,14,90
삼산주공7단지,40547,8066,6580,7808,6580,258,472
삼산주공7단지,40801,6299,8572,6145,8572,154,479
삼산중학교,40636,1236,893,1199,893,37,68
삼산중학교,40637,1221,1130,1183,1130,38,75
삼산체육관역(호수공원),40536,9768,3160,9666,3160,102,417
삼산체육관역(호수공원),40539,612,5682,595,5682,17,203
삼산체육관역.상동호수공원,55040,555,3935,521,3935,34,144
삼산체육관역.상동호수공원,55041,444,781,434,781,10,39
삼산체육관역.영상문화단지정문,55044,9822,3655,9775,3655,47,434
삼산타운1단지,40588,5527,7784,5473,7784,54,429
삼산타운1단지정문,40585,3147,1088,3093,1088,54,136
삼산타운1단지후문,40611,1322,713,1296,713,26,65
삼산타운1단지후문,40612,544,882,531,882,13,46
삼산타운4단지,40608,3000,868,2946,868,54,124
삼산타운6단지,40580,2557,2304,2510,2304,47,156
삼산타운7단지,40576,2848,2742,2794,2742,54,180
삼산푸른솔마을,40653,40,2246,32,2246,8,73
삼선1리마을회관,90263,1,9,1,9,0,0
삼선1리마을회관,90280,8,0,8,0,0,0
삼선1리삼거리,90262,0,8,0,8,0,0
삼선1리삼거리,90281,10,1,10,1,0,0
삼선2리마을회관,90265,0,26,0,26,0,0
삼선2리마을회관,90278,30,4,30,4,0,1
삼선2리입구,90264,2,11,2,11,0,0
삼선2리입구,90279,9,0,9,0,0,0
삼성바이오로직스,39863,85,1538,77,1538,8,52
삼성바이오로직스,39864,5046,110,5012,110,34,166
삼성바이오로직스,39920,3589,1917,3539,1917,50,177
삼성빌라(종점),37572,41,774,32,774,9,26
삼성아파트,35140,3127,5358,3073,5358,54,273
삼성아파트,38077,6154,6057,6053,6057,101,393
삼성아파트.남인천농협,38125,5678,8457,5590,8457,88,455
삼양감속기,39085,5,6,5,6,0,0
삼양베이커,35131,17,233,17,233,0,8
삼양베이커,35571,100,21,98,21,2,3
삼양사인천1공장,42027,1041,1751,1003,1751,38,90
삼양사인천1공장,42031,2989,3912,2958,3912,31,222
삼영물류,42068,7145,1218,7049,1218,96,269
삼영아파트,37116,4780,1387,4637,1387,143,198
삼영아파트,37279,12373,13141,12139,13141,234,823
삼영아파트,37280,9190,5883,8983,5883,207,486
삼영아파트,42085,12959,7219,12653,7219,306,650
삼영테크,89055,2230,202,2210,202,20,78
삼영테크,89062,33,3144,24,3144,9,102
삼원페트라,39041,449,4162,438,4162,11,148
삼은교회,37111,5041,1901,4942,1901,99,223
삼익.광명아파트,39247,10797,13706,10568,13706,229,790
삼익.광명아파트,39249,17320,8467,17080,8467,240,831
삼익아파트,35136,3318,7297,3170,7297,148,342
삼익아파트.달동네박물관,36017,11967,13946,11691,13946,276,835
삼일산업,39097,2489,1712,2445,1712,44,135
삼정동중소기업협동화단지,57015,1175,1648,1162,1648,13,91
삼정동중소기업협동화단지,57040,1274,909,1247,909,27,70
삼정사거리,57011,811,1086,803,1086,8,61
삼정사거리,57012,877,736,866,736,11,52
삼정초등학교,57008,1242,777,1213,777,29,65
삼정초등학교,57009,569,1036,562,1036,7,51
삼정프라자,42443,20056,26790,19742,26790,314,1511
삼진금속,39040,3537,290,3507,290,30,123
삼천리1차아파트,41178,3112,2326,3031,2326,81,175
삼천리1차아파트,41179,2795,2317,2728,2317,67,164
삼천리3차아파트,41150,6363,4321,6254,4321,109,344
삼천리3차아파트,41159,4755,5623,4677,5623,78,334
삼천리기계,92017,2,145,2,145,0,4
삼천리기계,92018,142,166,141,166,1,9
삼호제강2공장,39939,141,961,141,961,0,35
삼호제강2공장,39940,710,160,706,160,4,28
삼환1단지아파트,37252,1682,3004,1637,3004,45,151
삼환아파트,38063,1792,3074,1761,3074,31,156
삼환아파트,39296,236,1506,223,1506,13,56
삼환아파트,39299,3630,2425,3571,2425,59,195
삼환아파트,39316,13205,8884,13099,8884,106,712
삼환아파트,39323,965,4114,937,4114,28,163
삼환아파트,39328,8433,7892,8284,7892,149,526
삼환아파트,80058,24,2096,24,2096,0,68
상1리마을회관(창말),90339,1,16,1,16,0,0
상1리마을회관(창말),90342,15,0,15,0,0,0
상1주민지원센터,55074,2704,1725,2657,1725,47,142
상2리마을회관,90337,3,4,3,4,0,0
상2리마을회관,90343,32,0,32,0,0,1
상덕현삼거리,43462,8,15,6,15,2,0
상덕현삼거리,43767,4,9,4,9,0,0
상도중학교,55025,1786,91,1767,91,19,60
상도중학교,55028,440,1807,437,1807,3,72
상동가구,55090,1674,1441,1631,1441,43,100
상동역1번출구.부천터미널소풍.홈플러스,55052,6645,23743,6588,23743,57,980
상동역4번출구.상동지하차도,55048,1527,6204,1503,6204,24,249
상동역5번출구.상동지하차도,55050,15822,3027,15648,3027,174,608
상동역8번출구세이브존,55056,12490,4881,12315,4881,175,560
상사마을,25027,86,280,81,280,5,11
상수도사업본부(스마트타운),37375,5910,8823,5747,8823,163,475
상수도사업본부(스마트타운),37380,4887,12250,4761,12250,126,552
상야동,41436,1601,1553,1569,1553,32,101
상야동,41437,1434,1861,1427,1861,7,106
상용리마을회관,90038,0,84,0,84,0,2
상용리마을회관,90039,109,1,103,1,6,3
상용진료소앞,90004,28,94,26,94,2,3
상용진료소앞,90005,107,12,102,12,5,3
상인천중학교,39537,442,114,435,114,7,17
상인천초등학교,39340,1065,590,1039,590,26,53
상인천초등학교,39345,423,1235,419,1235,4,53
상정고,40069,14705,4315,14422,4315,283,613
상정고,40070,5730,13366,5660,13366,70,616
상정중학교,40059,5683,6264,5496,6264,187,385
상주(상리),90331,32,17,32,17,0,1
상주민지원센터.삼광교회,55029,1184,3925,1144,3925,40,164
상주민지원센터.삼광교회,55031,5309,439,5221,439,88,185
상촌,43152,41,13,40,13,1,1
상촌,43347,42,63,38,63,4,3
새꾸지마을,90133,36,31,36,31,0,2
새꾸지마을,90134,24,29,23,29,1,1
새마을,43471,6,6,6,6,0,0
새마을,43702,14,3,13,3,1,0
새마을금고,36053,2706,1136,2647,1136,59,123
새마을금고,40125,1134,1443,1099,1443,35,83
새마을금고,40126,2004,218,1904,218,100,71
새마을금고,40131,1144,3914,1114,3914,30,163
새마을금고,40746,59,886,48,886,11,30
새말사거리,41009,5355,2528,5270,2528,85,254
새말사거리,41010,169,3108,142,3108,27,105
새말사거리,41012,1475,4026,1428,4026,47,177
새말사거리,41013,4084,2860,4027,2860,57,224
새말사거리,41638,951,1906,931,1906,20,92
새봄초등학교,38679,2239,4469,2210,4469,29,216
새봄초등학교·송도파크레인(후문),38678,5563,2095,5494,2095,69,247
새사미아파트,41582,532,435,526,435,6,31
새소망교회,40850,2087,13,1998,13,89,67
새소망교회,40917,3,345,2,345,1,11
새안의원,37255,9997,11318,9735,11318,262,687
새안의원,37256,15976,6725,15753,6725,223,732
새한아파트,37046,4991,2616,4861,2616,130,245
색동원 앞,43161,8,5,6,5,2,0
색동원 앞,43215,2,0,2,0,0,0
샘말,43444,2,23,2,23,0,0
샘말,43782,24,10,24,10,0,1
샛말,43994,23,20,23,20,0,1
샛말,43995,18,15,18,15,0,1
생산기술연구원,38354,274,851,264,851,10,36
생설미,43746,547,312,524,312,23,27
생설미입구,43125,0,10,0,10,0,0
생설미입구,43607,20,3,17,3,3,0
생설미입구,43608,1,71,1,71,0,2
샬롬원입구,90293,7,8,7,8,0,0
샬롬원입구,90297,3,0,3,0,0,0
서곶지구대,42338,12478,8423,12168,8423,310,674
서곶지구대,42339,12420,10182,12249,10182,171,729
서교동,23037,209,5080,203,5080,6,170
서교동,23038,12318,236,12266,236,52,404
서구국민체육센터,42776,851,4008,833,4008,18,156
서구문화회관,42212,1628,2449,1578,2449,50,131
서구문화회관,42213,3402,1050,3361,1050,41,143
서구보건소,42283,5147,4016,4962,4016,185,295
서구보건소,42285,4370,4974,4287,4974,83,301
서구영어마을,42448,6677,4801,6579,4801,98,370
서구영어마을,42449,5464,9590,5257,9590,207,485
서구청역(1번출구),42289,4592,4782,4528,4782,64,302
서구청역(3번출구),42284,1389,867,1365,867,24,72
서구청역(4번출구),42296,2969,2780,2869,2780,100,185
서남촌,43151,13,0,13,0,0,0
서남촌,43640,2,11,2,11,0,0
서당골,35676,20,46,20,46,0,2
서당골,35702,44,17,44,17,0,1
서두머리,43212,21,4,21,4,0,0
서두머리,43336,4,12,4,12,0,0
서림초등학교,36036,9,841,5,841,4,27
서림초등학교,36047,15130,1353,14973,1353,157,531
서릿목,35418,166,498,161,498,5,21
서릿목,35419,571,160,544,160,27,23
서면초등학교,38384,1659,1495,1607,1495,52,101
서문안,43385,21,141,21,141,0,5
서문안,43584,277,13,237,13,40,9
서문안주유소,43965,134,8,123,8,11,4
서문안주유소,43966,20,246,20,246,0,8
서부경찰서,42286,579,811,574,811,5,44
서부공단입구,42299,3505,4315,3483,4315,22,252
서부공단입구,42301,5936,1205,5880,1205,56,230
서부산업단지,89035,45,56,41,56,4,3
서부산업단지,89036,37,332,37,332,0,11
서사체험학습장,43487,23,11,21,11,2,1
서사체험학습장,43712,20,16,19,16,1,1
서성,43234,21,184,19,184,2,6
서성,43362,258,48,230,48,28,9
서운교,41114,693,5310,668,5310,25,193
서운교,41115,4888,345,4801,345,87,168
서운도서관,41099,1853,267,1845,267,8,68
서운도서관,41102,224,2123,220,2123,4,75
서운동,41356,8204,3256,7987,3256,217,369
서운동성당,41207,1364,2363,1212,2363,152,120
서운일반산업단지,41660,580,4,577,4,3,18
서운일반산업단지(맞은편),41661,126,4,125,4,1,4
서운일반산업단지입구,41646,527,3767,520,3767,7,138
서운일반산업단지입구(맞은편),41647,1429,1110,1416,1110,13,81
서운중고등학교,41109,250,923,232,923,18,37
서운중고등학교,41111,700,592,691,592,9,41
서울경금속,39039,340,3138,338,3138,2,112
서울방화초등학교,25028,49,25,40,25,9,2
서울역,11013,23057,14294,22923,14294,134,1204
서원아파트,37095,1637,1264,1593,1264,44,93
서인천가구단지,42017,813,3078,797,3078,16,125
서인천가구단지,42028,3806,3034,3716,3034,90,220
서인천가구단지,42800,614,111,603,111,11,23
서인천고등학교,42346,4512,5055,4437,5055,75,308
서인천농협,42275,1498,542,1468,542,30,65
서인천농협,42277,210,819,210,819,0,33
서인천세무서,89044,324,91,304,91,20,13
서인천세무서(중),89275,1755,2352,1737,2352,18,132
서인천세무서(중),89276,1047,1831,1043,1831,4,92
서인천자동차검사소,42640,1379,3274,1364,3274,15,150
서인천자동차검사소,42641,5614,1891,5558,1891,56,242
서창119안전센터,39900,10973,3014,10707,3014,266,451
서창119안전센터,39899,5178,10582,5100,10582,78,508
서창공영차고지,39871,9139,141,8799,141,340,299
서창공영차고지,39872,2495,6446,1999,6446,496,288
서창도서관,39893,1565,2024,1513,2024,52,115
서창도서관,39894,2123,1583,2107,1583,16,119
서창도서관입구,39956,156,1726,147,1726,9,60
서창도서관입구,39957,2821,953,2777,953,44,121
서창동화원,39619,162,935,160,935,2,35
서창동화원,39620,671,390,666,390,5,34
서창베라체아파트후문,39895,267,92,254,92,13,11
서창베라체아파트후문,39896,29,530,29,530,0,18
서창센트라스아파트후문,39916,6612,643,6595,643,17,234
서창센트라스아파트후문,39917,983,3824,973,3824,10,155
서창센트럴푸르지오,39811,4131,338,4081,338,50,144
서창센트럴푸르지오,39812,341,3404,326,3404,15,120
서창센트럴푸르지오,39903,15348,7772,15078,7772,270,745
서창센트럴푸르지오,39904,13646,14404,13398,14404,248,904
서창이편한세상1002동,39905,13010,8189,12733,8189,277,683
서창이편한세상1002동,39906,7833,13209,7693,13209,140,678
서창이편한세상정문,39854,591,14088,553,14088,38,473
서창이편한세상정문,39855,14544,629,14251,629,293,489
서창퍼스트뷰후문,39777,12003,3032,11760,3032,243,485
서창퍼스트뷰후문맞은편,39778,1746,10223,1726,10223,20,386
서창휴먼시아12단지,39897,2767,203,2715,203,52,95
서창휴먼시아12단지,39898,253,2254,238,2254,15,80
서초구청,22129,329,45,329,45,0,12
서초동삼성아파트,22140,11,126,11,126,0,4
서초아트자이아파트,31050,5127,13361,5122,13361,5,596
서초역1번출구,31007,11771,31513,11748,31513,23,1396
서초힐스아파트,22286,824,1700,822,1700,2,81
서한리구마을회관,90294,14,9,14,9,0,0
서한리구마을회관,90296,12,1,12,1,0,0
서한리마을회관,90295,22,13,22,13,0,1
서한리입구,90292,0,1,0,1,0,0
서한리입구,90298,5,2,5,2,0,0
서해5도특별경비단,35098,1330,67,1283,67,47,45
서해그랑블,39621,1174,330,1174,330,0,48
서해그랑블,40828,2448,397,2161,397,287,91
서해그랑블,42789,3627,9594,3458,9594,169,426
서해그랑블,42790,7692,2928,7399,2928,293,342
서해그랑블,42912,4777,731,4661,731,116,177
서해그랑블1단지아파트,38604,959,65,954,65,5,33
서해그랑블1단지아파트,38605,109,413,108,413,1,16
서해그랑블3단지아파트,38725,378,99,376,99,2,15
서해그랑블3단지아파트,38726,43,289,42,289,1,10
서해그랑블아파트후문,39973,2068,2298,2045,2298,23,140
서해그랑블아파트후문,39974,2648,3418,2605,3418,43,195
서해그랑블후문,40610,65,1076,62,1076,3,36
서해수산연구소,35007,126,5,122,5,4,4
서해수산연구소,35008,18,223,18,223,0,7
서해아파트,38164,3296,786,3233,786,63,131
서해아파트,38169,746,2297,722,2297,24,98
서해아파트,41181,1644,2372,1586,2372,58,129
서해아파트,41182,3144,1551,3079,1551,65,151
서해아파트,42354,3859,9499,3745,9499,114,430
서해아파트,42355,15544,4020,15121,4020,423,631
서홍의입구,43446,0,13,0,13,0,0
서홍의입구,43796,26,4,26,4,0,0
서화초등학교(도화e편한세상),37438,13302,7874,13053,7874,249,683
서화초등학교(도화e편한세상),37623,10866,9936,10644,9936,222,671
서흥초등학교,36071,8250,3467,8011,3467,239,377
서흥초등학교,36116,809,295,766,295,43,35
서흥초등학교,36117,288,2401,273,2401,15,86
석건연립,37051,1833,6721,1813,6721,20,275
석남고가교입구사거리,42655,22115,9451,21938,9451,177,1018
석남고가사거리,42145,20376,16677,19996,16677,380,1195
석남고가사거리,42151,23321,17105,22989,17105,332,1304
석남금호어울림아파트101동,42656,4049,8480,4009,8480,40,404
석남도서관,42182,997,2139,971,2139,26,101
석남동차고지,89156,1157,9,999,9,158,37
석남서초등학교,42108,4897,3001,4846,3001,51,254
석남신사거리,42149,2596,1967,2533,1967,63,147
석남신사거리,42150,2354,2935,2252,2935,102,170
석남역(5번출구),42577,21059,37596,20812,37596,247,1892
석남중앙교회,42138,3046,1693,2982,1693,64,152
석남중학교,42126,8139,6366,7965,6366,174,467
석남중학교,42128,7523,7703,7306,7703,217,491
석남초등학교,42165,11381,3592,11078,3592,303,483
석남초등학교,42167,3697,9424,3632,9424,65,423
석락아파트,37241,13255,9683,12936,9683,319,739
석락아파트,37244,2669,4524,2587,4524,82,232
석모1리마을회관,90145,39,10,35,10,4,1
석모1리마을회관,90146,4,20,4,20,0,0
석모대교(석모리방향),90137,19,15,19,15,0,1
석모대교(석모리방향),90138,32,28,32,28,0,1
석모대교(석포리방향),90139,33,0,33,0,0,1
석모대교(석포리방향),90140,39,69,39,69,0,3
석모대교(외포리방향),90121,1,54,1,54,0,1
석모대교(외포리방향),90122,39,32,37,32,2,2
석모대교전망대,90249,7,19,7,19,0,0
석모대교전망대,90250,15,6,15,6,0,0
석모도미네랄온천,90163,79,27,78,27,1,3
석모도미네랄온천,90164,8,41,8,41,0,1
석모도수목원입구(삼산초등학교),90143,10,38,9,38,1,1
석모도수목원입구(삼산초등학교),90144,72,41,68,41,4,3
석모도자연휴양림입구,90151,2,19,2,19,0,0
석모도자연휴양림입구,90152,13,13,13,13,0,0
석바위,37365,28439,21095,27956,21095,483,1597
석바위,37370,59400,46527,58487,46527,913,3417
석바위시장,37378,2560,7414,2482,7414,78,321
석바위시장,37381,26574,25508,26109,25508,465,1680
석바위시장,37382,24629,22420,24222,22420,407,1517
석바위시장,37384,5639,4311,5508,4311,131,320
석바위시장,37544,3187,5661,3126,5661,61,285
석바위시장역,37373,4447,5043,4320,5043,127,306
석바위시장역,37374,3929,4358,3853,4358,76,267
석산,43375,24,106,19,106,5,4
석산,43833,18,13,14,13,4,1
석산로,92051,874,390,844,390,30,40
석산로,92052,287,625,284,625,3,29
석암초등학교,37412,4034,4276,3874,4276,160,268
석암초등학교앞,37407,14823,8424,14485,8424,338,749
석정여자고등학교,39416,1779,353,1704,353,75,68
석정여자고등학교,39418,159,1978,151,1978,8,68
석조여래입상앞,43663,0,39,0,39,0,1
석조여래입상앞,43692,85,2,82,2,3,2
석천사거리,39308,836,715,823,715,13,50
석천사거리역,39317,4180,7294,4080,7294,100,370
석천사거리역,39320,2958,3293,2902,3293,56,201
석천시장,39502,824,4692,788,4692,36,177
석포리마을회관,90191,48,9,45,9,3,1
석포리마을회관,90192,25,54,24,54,1,2
석포항,90203,46,35,35,35,11,2
선경그린빌라,42307,2468,2003,2409,2003,59,144
선경그린빌라,42541,35,679,35,679,0,23
선경아파트,40238,7630,1832,7589,1832,41,305
선광,38542,2,354,2,354,0,11
선광,38543,238,11,238,11,0,8
선녀바위유원지,35004,1277,65,1257,65,20,43
선녀바위유원지,35006,210,1197,203,1197,7,45
선녀바위해수욕장,35484,2541,204,2507,204,34,88
선녀바위해수욕장,35485,147,2234,147,2234,0,76
선동,43248,4,25,3,25,1,0
선동,43886,51,4,48,4,3,1
선두1리,43009,283,112,276,112,7,12
선두1리,43099,59,236,58,236,1,9
선두4리마을회관,43242,39,6,35,6,4,1
선두4리마을회관,43644,4,22,4,22,0,0
선두5리어판장입구,90131,7,23,7,23,0,0
선두5리어판장입구,90132,27,13,26,13,1,1
선릉역,23218,1783,2,1783,2,0,57
선릉역,23259,7,2972,7,2972,0,96
선린감리교회,40043,3045,1685,2963,1685,82,152
선린감리교회,40047,3869,5512,3804,5512,65,302
선바위역,66001,29351,865,29307,865,44,974
선바위역,66002,1431,47351,1424,47351,7,1573
선수,43433,1,20,1,20,0,0
선수,43483,21,5,13,5,8,0
선수여객선착장,43429,412,303,368,303,44,23
선수여객선착장,43479,39,58,39,58,0,3
선수촌사거리,39889,177,760,162,760,15,30
선수촌사거리,39890,506,416,484,416,22,29
선원면사무소앞,90067,1,19,1,19,0,0
선원면사무소앞,90068,10,13,8,13,2,0
선원면주민센터,43042,261,433,252,433,9,22
선원면주민센터,43070,539,237,501,237,38,25
선원사,43305,0,10,0,10,0,0
선원사,43742,21,14,18,14,3,1
선원사초입,43307,10,5,5,5,5,0
선원사초입,43756,1,17,1,17,0,0
선원초등학교,43044,42,138,40,138,2,5
선원초등학교,43045,184,47,176,47,8,7
선유고등학교,28017,15044,746,15021,746,23,509
선유고등학교,28018,784,15933,782,15933,2,539
선재대교,44085,18,0,17,0,1,0
선재대교,44175,1,2,1,2,0,0
선재대교입구,44005,50,896,49,896,1,30
선재대교입구,44006,1118,70,1103,70,15,38
선재바다낚시터,44146,0,1,0,1,0,0
선주삼거리,41481,1,97,0,97,1,3
선주삼거리,41502,4,0,4,0,0,0
선주지교회,41482,25,88,24,88,1,3
선주지교회,41503,5,2,4,2,1,0
선주지다리,41480,5,37,4,37,1,1
선주지다리,41501,1,4,1,4,0,0
선주지회차지,41483,49,79,47,79,2,4
선학동행정복지센터.정광아파트,38297,1303,1024,1289,1024,14,75
선학사거리,38295,1267,4706,1209,4706,58,192
선학아파트,38232,6988,1110,6928,1110,60,261
선학아파트,38343,3007,10603,2923,10603,84,439
선학어린이집,38300,2046,2017,2001,2017,45,131
선학역,38305,38466,18399,38145,18399,321,1834
선학역(1번출구),38306,22708,27740,22527,27740,181,1627
선학중학교,38283,825,995,790,995,35,58
선학체육관(하키경기장),38308,1866,1418,1802,1418,64,105
선학체육관(하키경기장),38309,1534,3400,1518,3400,16,159
선행리입구,43908,17,65,14,65,3,2
선행리입구,43909,46,0,45,0,1,1
설호아파트,43378,13,48,13,48,0,1
설호아파트,43618,64,104,63,104,1,5
성강지식산업센터,39837,591,767,576,767,15,43
성경,43603,166,16,158,16,8,5
성경,43771,20,230,20,230,0,8
성리중학교,39969,57,14,51,14,6,2
성리중학교,39979,3,129,3,129,0,4
성리초등학교,39200,23774,21629,23353,21629,421,1464
성리초등학교,39201,10786,17748,10592,17748,194,920
성문교회,39462,569,12,568,12,1,18
성문아파트,39591,4682,1833,4631,1833,51,210
성문아파트(문화연립),39257,3486,4540,3400,4540,86,258
성민병원,42159,16898,16105,16377,16105,521,1064
성민병원,42162,15849,19448,15458,19448,391,1138
성보공업,42007,2406,2254,2336,2254,70,150
성산교회,40572,1326,7800,1185,7800,141,294
성신아크릴산업,89313,187,0,178,0,9,6
성신아크릴산업,89327,0,135,0,135,0,4
성웅아파트,42048,3796,2619,3760,2619,36,206
성웅아파트,42051,4277,2756,4213,2756,64,226
성원기계,92016,967,1397,964,1397,3,76
성원빌딩.우편취급국,37425,12137,6185,12018,6185,119,591
성원아파트,70022,2025,10,2000,10,25,65
성일산업,39787,903,1371,893,1371,10,73
성일산업,39788,1044,707,1042,707,2,56
성일아파트후문앞,40311,757,457,745,457,12,39
성지아파트,38017,23302,42310,23098,42310,204,2116
성지아파트,41025,5726,3038,5616,3038,110,282
성지초등학교,41033,2002,4141,1949,4141,53,198
성지초등학교,41034,2886,1865,2841,1865,45,153
성터지,43038,339,129,300,129,39,15
성터지,43039,104,268,104,268,0,12
성호아파트,38204,12972,12335,12550,12335,422,816
세광2차아파트,43758,1866,570,1823,570,43,78
세광2차아파트,43857,413,1294,403,1294,10,55
세광아파트,43049,1030,2020,997,2020,33,98
세광아파트,43050,2613,709,2556,709,57,107
세농푸드,41510,72,2,71,2,1,2
세우산업,39094,1738,4753,1720,4753,18,209
세월천사거리,40489,4750,9790,4595,9790,155,469
세일빌라.인천산림조합,39158,2425,1320,2393,1320,32,120
세일빌라.인천산림조합,39159,5464,4136,5428,4136,36,309
세현정공,39033,1011,1958,1008,1958,3,95
세화파렛텍,90216,44,36,44,36,0,2
센타빌딩,39902,12910,13007,12618,13007,292,836
센트럴공원,38490,1095,3172,1072,3172,23,137
센트럴파크역,38397,10187,859,10171,859,16,356
센트럴파크역,38574,1715,2826,1706,2826,9,146
센트럴파크푸르지오아파트,38544,1961,1467,1926,1467,35,110
센트럴파크푸르지오아파트,38545,1125,1839,1047,1839,78,95
셀트리온(주),38319,220,647,219,647,1,27
셀트리온(주)앞,38513,417,290,376,290,41,22
셀트리온2공장앞,38474,879,700,860,700,19,50
셀트리온2공장앞,38475,1311,701,1299,701,12,64
소게,43185,9,121,8,121,1,4
소게,43243,84,8,77,8,7,2
소구월사거리,39266,6047,13087,5875,13087,172,617
소구월사거리,39268,5230,3819,4916,3819,314,291
소나무,43396,59,0,57,0,2,1
소나무,43805,1,36,1,36,0,1
소담(장미)마을입구,90236,1,0,1,0,0,0
소담(장미)마을입구,90237,3,9,3,9,0,0
소동,43412,168,5,156,5,12,5
소동,43829,1,201,1,201,0,6
소래도서관,39829,24,930,9,930,15,30
소래산등산로입구,39770,5,127,5,127,0,4
소래산등산로입구,39771,54,1,54,1,0,1
소래산입구,39668,30,796,30,796,0,26
소래산입구,39670,1368,106,1356,106,12,47
소래역사관,39816,223,1314,219,1314,4,49
소래역사관,39817,2571,136,2527,136,44,87
소래초등학교,39615,239,278,234,278,5,16
소래포구,39815,1710,102,1674,102,36,58
소래포구,39818,179,3479,179,3479,0,118
소래포구역,39647,3723,1626,3657,1626,66,172
소래포구역,39648,1773,4967,1697,4967,76,217
소래포구역,39710,3041,1208,2895,1208,146,137
소래포구역앞,92063,1563,1100,1557,1100,6,85
소래포구역종점,39793,618,21,565,21,53,20
소래포구입구,70009,1135,155,1109,155,26,41
소래포구입구(논현푸르지오A),39109,351,1343,343,1343,8,54
소래포구입구(논현푸르지오A),39114,326,189,324,189,2,16
소래풍림아파트,39122,2747,952,2662,952,85,119
소리공원(하모니로),38721,307,740,299,740,8,33
소리공원(하모니로),38722,251,245,247,245,4,16
소망탑빌라,40116,3,304,2,304,1,9
소방대앞,90022,8,48,5,48,3,1
소방대앞,90023,201,12,194,12,7,6
소산서원,70011,232,939,222,939,10,37
소산서원,70012,428,419,399,419,29,27
소장전,43996,5,21,5,21,0,0
소장전,43997,12,5,12,5,0,0
소촌마을,41662,85,9,85,9,0,3
속아지,43344,26,0,22,0,4,0
속아지,43848,0,33,0,33,0,1
솔밭마을,38193,744,319,728,319,16,34
솔빛마을,36034,9316,9402,9160,9402,156,603
솔빛마을,36037,6085,6714,5849,6714,236,412
솔빛마을주공아파트,36049,10781,7781,10482,7781,299,598
솔빛마을주공아파트,36050,10571,12245,10357,12245,214,736
솔빛주공2단지,36045,1079,781,1037,781,42,60
솔안공원,38348,11638,6457,11434,6457,204,583
솔정,43526,31,3,18,3,13,1
솔정,43871,5,13,3,13,2,0
솔정1리마을회관,90085,0,7,0,7,0,0
솔정1리마을회관,90086,7,0,6,0,1,0
솔정마을,43129,23,9,15,9,8,1
솔정마을,43811,17,1,15,1,2,0
솔정마을,43872,15,7,9,7,6,0
솔정마을,90108,1,3,1,3,0,0
솔정정미소,43130,15,32,14,32,1,1
솔정정미소,43134,52,3,39,3,13,1
솔터마을입구,80327,1302,341,1292,341,10,53
솔터마을입구,80336,1385,1177,1361,1177,24,82
솔펜션,44143,2,9,2,9,0,0
솔펜션,44177,8,1,8,1,0,0
송곡촌,43439,12,37,12,37,0,1
송곡촌,43815,66,19,65,19,1,2
송내고교입구,11014,89,341,86,341,3,13
송내고교입구,11015,670,177,666,177,4,27
송내고등학교,40219,2892,2920,2788,2920,104,187
송내남부역,40761,47,1327,45,1327,2,44
송내역.로데오거리,55267,4639,28193,4558,28193,81,1059
송내역.영화의거리,55263,25551,6610,25110,6610,441,1037
송내역남부,56002,107866,38900,107334,38900,532,4734
송내역남부,56005,117776,105471,116635,105471,1141,7201
송담초등학교,38667,2023,701,1946,701,77,87
송담초등학교,38668,882,1965,851,1965,31,91
송도1동행정복지센터,38012,5730,14217,5655,14217,75,643
송도2동행정복지센터,38492,4894,2838,4825,2838,69,249
송도2동행정복지센터,38588,723,2140,678,2140,45,92
송도MTB파크,38746,0,19,0,19,0,0
송도SK뷰(101동),38635,485,122,458,122,27,19
송도SK뷰(105동),38632,57,213,54,213,3,8
송도SK뷰(105동),38633,962,113,948,113,14,34
송도sk뷰,38707,1179,2507,1058,2507,121,118
송도sk뷰,38708,297,1528,272,1528,25,58
송도고입구,38215,3295,3789,3018,3789,277,228
송도고입구,38221,3532,1170,3385,1170,147,151
송도공영차고지,38472,493,38,367,38,126,17
송도국제교입구,38597,87,0,87,0,0,2
송도글로벌캠퍼스푸르지오아파트,38711,784,508,759,508,25,41
송도누리공원,38663,2971,4292,2914,4292,57,234
송도누리공원,38664,818,2806,811,2806,7,116
송도달빛축제공원역,38696,14106,2865,13982,2865,124,547
송도달빛축제공원역,38697,2325,12534,2285,12534,40,479
송도더삽그린워크(3차),38530,101,209,97,209,4,10
송도더샵그린스퀘어,39843,4729,1672,4662,1672,67,206
송도더샵그린워크,38526,1365,587,1345,587,20,62
송도더샵그린워크2차,38493,2436,3568,2381,3568,55,193
송도더샵그린워크3차18블럭,38719,152,626,130,626,22,25
송도더샵마스터뷰21단지,38578,3257,501,3144,501,113,121
송도더샵마스터뷰22단지,38693,899,402,887,402,12,41
송도더샵마스터뷰22단지(2202동),38698,68,258,66,258,2,10
송도더샵마스터뷰22단지(2202동),38712,179,469,178,469,1,20
송도더샵마스터뷰22단지(정문),38694,318,1087,304,1087,14,45
송도더샵마스터뷰22단지(하행),38695,228,909,218,909,10,36
송도더샵마스터뷰23단지,38441,4045,4511,3928,4511,117,276
송도더샵마스터뷰23단지,38442,477,8005,445,8005,32,273
송도더샵마스터뷰23단지(정문),38692,1188,206,1159,206,29,44
송도더샵센트럴시티,39842,2773,3888,2686,3888,87,214
송도더샵센트럴시티.글로벌캠퍼스푸르지오,38647,4070,966,4051,966,19,162
송도더샵퍼스트월드,38589,922,1089,895,1089,27,64
송도더샵퍼스트월드(동문),38013,16930,6546,16831,6546,99,757
송도더샵퍼스트월드(서문),38381,3552,1110,3505,1110,47,150
송도더샵퍼스트월드B동.C동,38425,4256,2094,4202,2094,54,204
송도더샵퍼스트월드D동,38009,1905,1950,1837,1950,68,124
송도더샵퍼스트파크14단지,38560,804,2089,766,2089,38,93
송도더샵퍼스트파크14단지,38577,1737,330,1710,330,27,66
송도더샵퍼스트파크15단지,38559,332,747,315,747,17,34
송도더샵퍼스트파크15단지,38576,686,125,645,125,41,26
송도더샵하버뷰2차,38467,2513,15055,2454,15055,59,566
송도동일하이빌파크포레아파트,38680,3680,1034,3613,1034,67,152
송도라마다호텔앞,38065,2481,4621,2448,4621,33,229
송도라마다호텔앞,38067,12588,8491,12301,8491,287,679
송도랜드마크시티13호근린공원,38738,43,444,43,444,0,15
송도랜드마크시티13호근린공원,38739,177,221,174,221,3,12
송도베르디움더퍼스트후문,39985,1012,4422,986,4422,26,175
송도세브란스병원,38651,49,850,49,850,0,29
송도센트럴파크,38452,1041,7244,1038,7244,3,267
송도센트럴파크역,38563,2338,609,2302,609,36,95
송도소방서(송도스마트밸리),39801,2247,2556,2232,2556,15,154
송도스마트밸리,39802,4276,2493,4247,2493,29,218
송도스포츠센터(LNG야구장),39721,1438,1137,1408,1137,30,83
송도아트윈푸르지오,38549,445,580,433,580,12,33
송도아트윈푸르지오,38562,5,274,5,274,0,9
송도에듀포레푸르지오,39921,1333,4712,1304,4712,29,195
송도에듀포레푸르지오후문,39986,4364,511,4320,511,44,157
송도역,38213,2522,6687,2501,6687,21,297
송도역,38505,10478,13022,10293,13022,185,758
송도역,38669,971,1010,958,1010,13,63
송도영남아파트,38224,11583,7846,11350,7846,233,626
송도오션파크베르디움,38642,1044,15125,1008,15125,36,521
송도요양원,38144,1909,2130,1829,2130,80,130
송도유원지(도로교통공단),38081,10439,13475,10209,13475,230,771
송도유원지(도로교통공단),38088,16727,7000,16282,7000,445,765
송도자이하버뷰,38521,3863,1610,3827,1610,36,176
송도자이하버뷰1단지,38468,18832,2721,18695,2721,137,695
송도자이하버뷰2단지(202동),38488,2800,3975,2639,3975,161,218
송도자이하버뷰2단지(205동),38455,630,671,598,671,32,41
송도자이하버뷰2단지(정문),38465,2201,1149,2168,1149,33,108
송도자이하버뷰2단지(정문),38498,1242,1970,1197,1970,45,103
송도재래시장,38207,5984,8746,5772,8746,212,475
송도재래시장,38210,8479,5604,8278,5604,201,454
송도재래시장,38220,5936,2984,5816,2984,120,287
송도제2차고지,38703,543,21,374,21,169,18
송도제2차고지입구,38735,199,965,135,965,64,37
송도중학교,35155,14332,15509,13602,15509,730,962
송도지웰푸르지오시티,38424,5891,8546,5863,8546,28,465
송도채석장,38175,817,2743,785,2743,32,114
송도체육센터,38699,102,479,100,479,2,18
송도체육센터,38700,435,167,409,167,26,19
송도컨벤시아,38367,1756,6578,1715,6578,41,268
송도컨벤시아,38369,2861,1189,2782,1189,79,130
송도컨벤시아남문,38660,1739,1103,1719,1103,20,91
송도컨벤시아남문,38661,1088,1762,1072,1762,16,91
송도타임스페이스,38720,826,1955,810,1955,16,89
송도테크노파크IT센터,39929,5872,4251,5851,4251,21,326
송도파크레인동일하이빌,38625,47,101,44,101,3,4
송도파크레인동일하이빌,38626,933,16,922,16,11,30
송도파크레인입구,38538,394,3256,373,3256,21,117
송도파크레인입구,38539,1449,1449,1427,1449,22,93
송도파크자이,38627,987,509,979,509,8,48
송도파크자이,38628,18,884,13,884,5,29
송도파크자이아파트,38638,8710,7620,8441,7620,269,526
송도파크자이아파트정문,38677,1271,5284,1250,5284,21,211
송도푸르지오월드마크,38426,4885,6745,4799,6745,86,375
송도푸르지오하버뷰,38494,3843,4606,3737,4606,106,272
송도풍림아이원1단지,38033,3283,25590,3124,25590,159,931
송도풍림아이원2단지,38025,8491,16202,8104,16202,387,796
송도풍림아이원2단지,38026,10105,5107,9898,5107,207,490
송도풍림아이원2단지,38034,28350,2933,27804,2933,546,1009
송도풍림아이원4단지,38032,3728,9714,3521,9714,207,433
송도힐스테이트,38479,15008,6833,14647,6833,361,704
송도힐스테이트5단지,38393,5841,9085,5710,9085,131,481
송도힐스테이트6단지,38554,48,207,48,207,0,8
송동마을.서초힐스아파트,22962,1146,149,1144,149,2,41
송림119안전센터,36165,70,185,68,185,2,8
송림3.5동행정복지센터(재능대정문),36030,1998,9586,1937,9586,61,373
송림4동행정복지센터(재능대후문),36127,273,813,253,813,20,35
송림고가교,37491,1966,1634,1931,1634,35,116
송림고가교,37492,1083,1858,1062,1858,21,94
송림고개(도화신동아아파트),37439,8111,9235,7845,9235,266,559
송림고개(도화신동아아파트),37501,12270,7350,11959,7350,311,632
송림동진로아파트,36154,275,367,273,367,2,20
송림동진로아파트,36155,174,877,162,877,12,33
송림빌라,43316,25,0,25,0,0,0
송림빌라,43775,34,34,34,34,0,2
송림시장,36015,210,328,192,328,18,17
송림오거리,36131,15954,4121,15712,4121,242,647
송림오거리,36132,3673,9967,3551,9967,122,440
송림주공아파트,36171,15,1,15,1,0,0
송림주공아파트,36176,0,1,0,1,0,0
송림주유소,36090,582,429,530,429,52,32
송림체육관,36130,513,41,511,41,2,17
송림체육관,36148,3,338,3,338,0,11
송림체육관후문,36152,79,763,76,763,3,27
송림체육관후문,36153,379,122,371,122,8,16
송림휴먼시아,36124,15,705,15,705,0,23
송림휴먼시아,36125,167,2290,164,2290,3,79
송림휴먼시아정문,36164,68,1,68,1,0,2
송림휴먼시아정문,36180,0,28,0,28,0,0
송마3리,80157,518,18,504,18,14,17
송마3리,80158,31,266,26,266,5,9
송마리입구,80159,40,736,35,736,5,25
송마리입구,80160,498,152,488,152,10,20
송명초등학교,92013,2976,212,2932,212,44,102
송산,43482,110,58,107,58,3,5
송산,43710,71,63,68,63,3,4
송산교회,43956,22,29,17,29,5,1
송산삼거리,43480,77,5,65,5,12,2
송산삼거리,43611,2,46,2,46,0,1
송암박두성생가입구,90396,0,18,0,18,0,0
송월동동화마을,35189,7238,3839,7016,3839,222,357
송월동동화마을,35190,4640,8953,4523,8953,117,438
송월아파트,35193,3366,753,3249,753,117,132
송월아파트,35194,1085,3318,1046,3318,39,142
송정역,25184,58,2732,54,2732,4,90
송정역,25185,4952,62,4912,62,40,161
송학둥지아파트,38584,3558,3835,3435,3835,123,238
송학둥지아파트,38585,1975,4542,1890,4542,85,210
송해교회,43384,310,88,296,88,14,12
송해교회,43769,99,329,97,329,2,13
송해면사무소,43708,26,144,25,144,1,5
송해면사무소,43809,109,48,105,48,4,5
송해삼거리,43386,434,58,411,58,23,15
송해삼거리,43819,141,477,132,477,9,19
송해초등학교,43807,3,147,3,147,0,4
송해초등학교,43820,102,17,98,17,4,3
송현시장.수도국산달동네박물관,36019,5944,5080,5616,5080,328,355
송현시장.수도국산달동네박물관,36020,5596,22029,5402,22029,194,891
송현시장.수도국산달동네박물관,36025,64,407,58,407,6,15
송현아파트,36065,6366,3546,6195,3546,171,319
송현아파트,36067,2253,5082,2188,5082,65,236
송현주공아파트,36073,837,3112,821,3112,16,127
송현주공아파트,36080,12650,5806,12268,5806,382,595
송현주공아파트후문,36162,592,2881,585,2881,7,112
쇠골큰말,89318,44,15,44,15,0,1
쇠골큰말,89321,93,18,86,18,7,3
수곡(월곳리),43191,61,0,57,0,4,1
수곡(월곳리),43620,0,35,0,35,0,1
수광티티아이,90215,26,43,26,43,0,2
수도군수지원단(장애인복지관),40825,5911,1629,5789,1629,122,243
수도군수지원단(장애인복지관),40826,59,2262,45,2262,14,74
수림공원,39347,2028,721,1966,721,62,88
수림공원,39351,643,1808,632,1808,11,79
수변로삼거리,40367,968,532,936,532,32,48
수변로삼거리,40370,2553,4337,2524,4337,29,222
수봉공원,37289,2382,1264,2332,1264,50,117
수봉공원,37569,1090,3815,1075,3815,15,158
수봉공원.인천수봉문화회관입구,37362,13957,6853,13501,6853,456,671
수봉공원.인천수봉문화회관입구,37369,9095,14695,8880,14695,215,767
수봉마을쉼터,37570,3625,3020,3423,3020,202,214
수봉마을쉼터,37571,2377,1810,2326,1810,51,135
수부촌,43041,166,201,163,201,3,11
수산동,39175,405,936,395,936,10,43
수산동,39176,496,652,476,652,20,37
수양관,43245,31,79,31,79,0,3
수양관,43645,58,9,51,9,7,2
수인곡물시장,35134,2530,2732,2430,2732,100,169
수정제입구,90290,4,2,4,2,0,0
수촌,43111,108,2,101,2,7,3
수촌,43358,3,87,3,87,0,2
수출산업단지6공단입구,40009,3692,4925,3615,4925,77,277
수출산업단지6공단입구,40010,2424,2632,2400,2632,24,163
수행마을.홈플러스,80074,658,5,656,5,2,21
수행마을.홈플러스,80075,42,499,42,499,0,17
수현마을,39487,2913,4511,2847,4511,66,239
수현마을,39488,8173,5591,7917,5591,256,444
수협,43059,0,3,0,3,0,0
수협,43060,178,1126,171,1126,7,42
수협,43062,3236,10061,3139,10061,97,428
수협(인천해양센터),35080,3647,118,3485,118,162,121
수협(인천해양센터),35081,117,5940,114,5940,3,195
순복음교회,37253,9575,28440,9280,28440,295,1226
순복음교회,39181,20205,8518,19435,8518,770,926
순복음교회,40661,12462,6341,12359,6341,103,606
순천향대학병원.부명고,55037,8029,993,7882,993,147,291
숭덕여중고입구,39461,13942,25526,13788,25526,154,1273
숭덕여중고입구,39463,17199,13370,16811,13370,388,986
숭덕여중고입구,39466,7793,1327,7684,1327,109,294
숭뢰2리,43421,97,231,87,231,10,10
숭뢰2리,43704,191,34,172,34,19,7
숭보사입구,40851,187,43,180,43,7,7
숭보사입구,40918,8,79,2,79,6,2
숭의1.3동(극동아파트),37328,1022,1362,968,1362,54,76
숭의1.3동(극동아파트),37337,1104,1341,1043,1341,61,78
숭의2동행정복지센터,37563,1714,2078,1690,2078,24,122
숭의교회,37269,18148,11534,17701,11534,447,957
숭의교회,37271,13829,15253,13392,15253,437,938
숭의로터리,37265,6329,18892,6117,18892,212,813
숭의로터리,37266,16875,5296,16552,5296,323,715
숭의로터리,37273,19457,9443,19006,9443,451,932
숭의로터리.도원체육관,37276,9608,14716,9260,14716,348,784
숭의목공예마을앞,37313,9024,8248,8747,8248,277,557
숭의목공예마을앞,37315,5712,6544,5585,6544,127,395
숭의박문아파트,37353,2584,3846,2552,3846,32,207
숭의박문아파트,37354,3592,2285,3480,2285,112,189
숭의보건지소,37532,14968,3864,14708,3864,260,607
숭의역(1번출구),37510,45555,22082,44898,22082,657,2181
숭의역(2번출구),37211,27934,35746,27684,35746,250,2054
숭의역(3번출구),35133,1096,3164,1048,3164,48,137
숭의역(4번출구),35135,3402,2495,3320,2495,82,190
숭의초등학교,37296,993,684,940,684,53,54
숭의초등학교,37308,1179,3307,1151,3307,28,144
숭의초등학교입구,37287,1508,1733,1447,1733,61,104
쉐보레인천서비스,40433,1607,4331,1580,4331,27,191
쉐보레출고사무소,89160,1945,14,1886,14,59,63
쉴낙원인천장례식장,41458,1184,2023,1143,2023,41,103
스카이시티자이.화성파크드림,35650,2155,6304,2109,6304,46,272
스타파이브입구,35428,279,39,270,39,9,10
스타파이브입구,35429,21,301,21,301,0,10
스태츠칩팩코리아,35641,5,401,5,401,0,13
스태츠칩팩코리아,35642,323,5,312,5,11,10
스틸랜드,70228,159,551,153,551,6,22
스틸랜드,70229,432,163,431,163,1,19
스포월드골프연습장,42439,83,198,83,198,0,9
스포월드골프연습장,42440,22,128,22,128,0,4
승기천,39169,1213,7088,1177,7088,36,267
승기천,39170,940,5033,910,5033,30,192
시대아파트,38340,18494,13764,18180,13764,314,1040
시리미,43330,60,58,53,58,7,3
시리미,43631,14,1,14,1,0,0
시립가좌테니스장,37581,195,1181,183,1181,12,44
시립가좌테니스장,37582,177,2498,171,2498,6,86
시민공원,37359,14207,4760,13812,4760,395,611
시민공원(문화창작지대)역,37344,21421,19153,21112,19153,309,1308
시민공원(문화창작지대)역,37346,32500,30673,31823,30673,677,2037
시민공원.문화창작지대,37334,18457,32197,17990,32197,467,1634
시민공원.문화창작지대,37468,1676,1725,1640,1725,36,109
시민공원역.포레나미추홀,37319,8545,60834,8392,60834,153,2238
시민공원역.포레나미추홀,37326,84069,18484,83027,18484,1042,3308
시민의숲.양재꽃시장,31002,15392,4565,15372,4565,20,643
시민의숲.양재꽃시장,31003,1674,3343,1668,3343,6,161
시장로터리(중앙철재),40261,2583,2010,2562,2010,21,148
시청광장입구,39217,16962,20617,16637,20617,325,1212
시청광장입구,39218,21236,18066,21059,18066,177,1267
시흥대야역.영남아파트,70027,354,1498,354,1498,0,59
시흥대야역.영남아파트,70028,1487,355,1451,355,36,59
시흥보건소,70015,2067,416,2030,416,37,80
시흥보건소,70016,501,1748,474,1748,27,72
시흥영업소,25846,162,80,162,80,0,7
시흥영업소,25847,59,145,58,145,1,6
신골입구,43998,22,58,17,58,5,2
신골입구,43999,66,18,64,18,2,2
신광주유소,43470,2,2,2,2,0,0
신광주유소,43524,2,12,2,12,0,0
신광초등학교,35142,474,379,448,379,26,27
신기.남부종합시장(진흥사거리),37217,52295,30560,51082,30560,1213,2672
신기.남부종합시장(진흥사거리),37219,17042,29919,16601,29919,441,1514
신김포농협대곶지점,80147,76,48,75,48,1,4
신김포농협대곶지점,80148,167,170,158,170,9,10
신논현역,32055,12423,100,12411,100,12,403
신논현역.우신빌딩,31057,59,6931,59,6931,0,225
신당리동촌부락,90090,5,0,4,0,1,0
신당리마을회관,90087,2,2,1,2,1,0
신당리마을회관,90088,11,1,11,1,0,0
신당촌,90114,15,0,15,0,0,0
신대진중앙아파트,41271,3840,3172,3796,3172,44,226
신대진중앙아파트,41274,2295,3613,2274,3613,21,190
신도실업(주),40625,617,1778,615,1778,2,77
신동마을,90253,4,3,4,3,0,0
신동마을,90254,17,13,15,13,2,0
신동아1.2차아파트,37507,10884,6445,10715,6445,169,559
신동아1단지,70038,174,164,140,164,34,10
신동아1단지.한일아파트,70037,161,174,159,174,2,10
신동아3차아파트,37119,13145,17197,12892,17197,253,978
신동아3차아파트,37120,12235,21191,12116,21191,119,1078
신동아3차아파트,37494,12415,5922,12189,5922,226,591
신동아상가,40860,5671,4271,5639,4271,32,320
신동아상가(백운역방면),40068,5275,7464,5179,7464,96,410
신동아아파트,37072,13,1091,12,1091,1,35
신동아아파트,37143,9476,14355,9247,14355,229,768
신동아아파트,37160,6296,8140,6173,8140,123,465
신동아아파트,37525,2630,8633,2543,8633,87,363
신동아아파트,39381,3554,7555,3513,7555,41,358
신동아아파트,39382,18466,7206,18218,7206,248,828
신동아아파트,41349,7560,994,7540,994,20,275
신동아아파트,41350,1667,6885,1641,6885,26,275
신동아아파트(B),37162,12167,11477,11979,11477,188,762
신동아아파트116동,40060,3332,11398,3265,11398,67,475
신동아아파트116동,40859,7997,3010,7957,3010,40,355
신동아아파트3차,37090,10975,1117,10783,1117,192,390
신동아아파트3차,37097,3907,9689,3809,9689,98,438
신동아아파트4차,37121,5245,1651,5161,1651,84,222
신동아아파트4차,37123,2417,3751,2352,3751,65,198
신동아아파트5차,37141,13497,4295,13317,4295,180,573
신동아아파트8차,37135,1723,3513,1686,3513,37,168
신동아아파트8차,37136,5231,1079,5166,1079,65,203
신동양아파트,41202,3019,8469,2990,8469,29,370
신동양아파트,41203,8286,3893,8162,3893,124,392
신라아파트,37277,7492,6643,7310,6643,182,455
신라아파트,37543,1678,4218,1609,4218,69,190
신명보람마을.삼부한신아파트,40511,2135,2803,2075,2803,60,159
신명보람마을.삼부한신아파트,40512,649,804,634,804,15,46
신명스카이뷰,35453,1315,2477,1267,2477,48,122
신명스카이뷰,35456,6084,4998,5904,4998,180,357
신명스카이뷰,42737,171,282,168,282,3,14
신명스카이뷰정문,35455,6448,6063,6293,6063,155,403
신명아파트,42081,9409,12311,9188,12311,221,700
신명아파트.대우3차아파트,70018,433,3031,398,3031,35,111
신명아파트앞,42799,17,1291,17,1291,0,42
신반포역.세화여중고,31033,933,63,930,63,3,32
신봉삼거리,43126,90,5,90,5,0,3
신봉삼거리,43127,8,35,7,35,1,1
신봉삼거리,43463,22,33,20,33,2,1
신봉삼거리,43814,15,18,15,18,0,1
신봉이발관,43458,43,3,41,3,2,1
신봉이발관,43786,0,61,0,61,0,1
신북항고가교,42104,3107,2419,3063,2419,44,178
신북항고가교,42109,2150,2730,2138,2730,12,157
신분당선.강남역4번출구,23572,12083,2626,12076,2626,7,474
신비마을아파트,37164,312,1918,300,1918,12,71
신비마을아파트,37223,5086,8107,5012,8107,74,425
신비마을아파트,37225,6868,4607,6749,4607,119,370
신비마을아파트,37555,358,1399,352,1399,6,56
신비마을아파트(112동),37171,5424,3941,5252,3941,172,302
신삼1리마을회관,43405,156,2,147,2,9,5
신삼1리마을회관,43791,10,124,9,124,1,4
신삼2리마을회관,43400,114,1,102,1,12,3
신삼2리마을회관,43825,14,109,13,109,1,3
신삼리입구,43606,13,11,12,11,1,0
신삼리입구,43801,18,65,18,65,0,2
신선지입구,90346,21,1,16,1,5,0
신선지입구,90347,0,17,0,17,0,0
신선초등학교,35086,6434,11412,6328,11412,106,575
신선초등학교(유림노르웨이숲),35089,7347,3638,7230,3638,117,354
신선초등학교앞,37055,3026,1010,2904,1010,122,130
신설동,35413,9,74,8,74,1,2
신설동,35416,41,24,38,24,3,2
신설동(3거리),35018,182,18,167,18,15,6
신설동(3거리),35019,26,262,25,262,1,9
신성미소지움,40099,2671,34,2433,34,238,87
신성미소지움,40102,99,2154,22,2154,77,72
신성미소지움,40643,1774,13233,1747,13233,27,484
신성미소지움,40649,6787,2165,6657,2165,130,288
신성미소지움후문,40660,2,417,2,417,0,13
신성성결교회(올림피아병원),39355,12926,8203,12748,8203,178,681
신세계아파트,39383,3176,4836,3062,4836,114,258
신송고등학교,38023,1785,3383,1704,3383,81,166
신송고등학교,38024,3524,2586,3258,2586,266,197
신안실크밸리,35220,813,320,775,320,38,36
신연수역(1번출구),38263,4435,4899,4342,4899,93,301
신연수역(2번출구),38231,2851,656,2839,656,12,113
신연수역(3번출구),38228,6128,4401,6043,4401,85,339
신영자동차,40561,4361,698,4301,698,60,163
신영자동차(종점),40556,5698,2864,5613,2864,85,276
신왕마을,43203,193,4,175,4,18,6
신왕마을,43718,2,121,2,121,0,3
신원기술,39130,19,11,18,11,1,0
신원아침도시오피스텔(홈플러스),39836,6274,6468,6208,6468,66,411
신일교회,39529,4648,7722,4538,7722,110,399
신일아파트,35097,28,2,28,2,0,0
신정1리마을회관,43300,24,8,23,8,1,1
신정1리마을회관,43737,16,1,14,1,2,0
신정삼거리,90111,0,7,0,7,0,0
신정삼거리,90112,18,2,15,2,3,0
신정중학교,38459,1097,1293,1015,1293,82,77
신정중학교,38555,1602,640,1516,640,86,72
신중동역4번출구.롯데백화점,55226,2098,7419,2093,7419,5,307
신중동역5번출구.중흥중학교,55071,1049,7493,1047,7493,2,275
신중동역6번출구.중흥중학교,55072,4174,775,4172,775,2,159
신지동마을회관,43303,88,56,85,56,3,4
신지동마을회관,43740,83,39,78,39,5,3
신진아파트,41107,26710,13931,26441,13931,269,1311
신창아파트,37010,3439,6686,3076,6686,363,326
신창아파트,37464,5649,2152,5577,2152,72,251
신천동,70048,7832,587,7638,587,194,271
신천동,70049,380,7859,364,7859,16,265
신천삼거리,70013,7659,410,7464,410,195,260
신천삼거리,70014,569,7606,542,7606,27,263
신천역.문화의거리,25364,1094,338,1083,338,11,46
신천역.문화의거리,70174,214,1173,199,1173,15,44
신천연합병원,70175,72,786,68,786,4,27
신천연합병원,70231,699,234,695,234,4,30
신촌,43146,47,0,47,0,0,1
신촌,43432,9,8,9,8,0,0
신촌,43459,273,12,263,12,10,9
신촌,43510,0,23,0,23,0,0
신촌,43753,23,182,23,182,0,6
신촌,43800,62,57,62,57,0,3
신촌마을입구,90201,31,10,27,10,4,1
신촌마을입구,90202,2,4,1,4,1,0
신촌역2호선,22052,4508,65,4499,65,9,147
신촌오거리.2호선신촌역,22014,6689,96,6670,96,19,218
신촌오거리.2호선신촌역,23035,89,3151,86,3151,3,104
신촌오거리.현대백화점,22013,12932,137,12887,137,45,421
신촌오거리.현대백화점,23034,285,16544,283,16544,2,542
신촌초등학교,40098,250,794,233,794,17,33
신태양아파트,37406,6091,7744,6024,7744,67,446
신태양아파트,37408,9529,4147,9479,4147,50,441
신트리공원,40472,2382,2540,2281,2540,101,158
신트리공원,40496,2664,4395,2591,4395,73,227
신트리공원,40501,2557,1683,2519,1683,38,136
신포동행정복지센터,35153,3911,2316,3850,2316,61,200
신포동행정복지센터,35154,1949,3610,1874,3610,75,179
신포사거리,35791,29,199,25,199,4,7
신포시장,35160,34682,55479,33861,55479,821,2908
신포시장,35254,59566,34901,58197,34901,1369,3047
신포역·인천세관역사공원,35792,233,138,232,138,1,11
신포역·인천세관역사공원,35796,18,12,18,12,0,0
신포역·인천여자상업고등학교,35149,1736,7915,1607,7915,129,311
신포역·인천여자상업고등학교,35150,8041,2931,7973,2931,68,353
신포입구,43491,54,37,44,37,10,2
신포입구,43842,38,24,31,24,7,2
신한빌딩,39901,11150,9873,10999,9873,151,678
신한에이엠,89147,414,18,412,18,2,13
신한일전기,39034,2191,1280,2155,1280,36,111
신현119안전센터,42596,11190,14022,10974,14022,216,813
신현119안전센터,42600,8642,10795,8440,10795,202,627
신현노인회관,43279,40,6,37,6,3,1
신현노인회관,43527,18,33,17,33,1,1
신현리입구,90062,23,84,22,84,1,3
신현북초등학교,42208,4815,332,4771,332,44,166
신현북초등학교,42209,364,3707,354,3707,10,131
신현북초등학교,42210,1342,244,1316,244,26,51
신현북초등학교,42211,67,1608,61,1608,6,54
신현쇼핑,42217,35085,29051,34113,29051,972,2068
신현쇼핑,42220,48422,25640,47652,25640,770,2389
신현여자중학교후문,42214,3344,4266,3200,4266,144,245
신현여자중학교후문,42680,3552,1891,3454,1891,98,175
신현중학교,42205,127,3459,107,3459,20,115
신현초등학교,42178,1932,1989,1856,1989,76,126
신현초등학교,42179,2063,3212,2002,3212,61,170
신화빌라,42626,490,442,484,442,6,30
신화슈퍼,89314,161,0,153,0,8,5
신화슈퍼,89326,2,233,2,233,0,7
신흥교통,35501,357,100,312,100,45,14
신흥교통입구,35841,1383,28,1331,28,52,45
신흥동주민자치센터,35789,118,34,113,34,5,4
신흥동주민자치센터,35799,46,17,44,17,2,2
신흥시장,35145,12746,15608,12427,15608,319,914
신흥시장,35146,17931,9163,17265,9163,666,874
신흥시장,57002,3270,1380,3171,1380,99,150
신흥시장,57004,1824,2856,1804,2856,20,150
신흥시장후문,35812,57,52,55,52,2,3
신흥시장후문,35813,65,57,63,57,2,3
신흥주민지원센터,57013,4129,1836,4067,1836,62,192
신흥주민지원센터,57014,1898,3782,1846,3782,52,183
신흥초등학교,35156,8914,11086,8643,11086,271,645
실내게이트볼장(신현중학교),42204,5385,142,5299,142,86,178
실미도조개구이,35299,3,20,3,20,0,0
실미삼거리,35740,530,110,508,110,22,20
실미삼거리,35741,84,299,84,299,0,12
심곡극동아파트,42272,2198,393,2114,393,84,83
심곡극동아파트,42273,234,1420,230,1420,4,53
심곡도서관,42946,1501,1123,1472,1123,29,84
심곡도서관,89223,525,2320,513,2320,12,91
심곡동광명아파트,89153,6525,2650,6291,2650,234,295
심곡동광명아파트,89154,2403,4369,2354,4369,49,218
심곡천(심곡3교),89381,83,0,83,0,0,2
심곡천(심곡3교),89382,9,177,1,177,8,6
심곡천봉수교,42875,662,533,644,533,18,38
심곡천봉수교,42951,1713,5601,1677,5601,36,235
심곡초등학교(국제성모병원),42288,4304,5867,4178,5867,126,328
심곡초등학교(국제성모병원),42290,6016,4464,5896,4464,120,338
심팩이엔지,89387,0,246,0,246,0,7
십리포제2주차장,44110,81,88,80,88,1,5
십리포해수욕장,44088,140,131,138,131,2,8
십정1동행정복지센터,40049,8525,9096,8369,9096,156,568
십정2동행정복지센터,40056,5727,7025,5639,7025,88,411
십정동차고지,40913,2635,175,2521,175,114,90
십정사거리,40029,7014,5630,6917,5630,97,407
십정사거리,40033,3194,3434,3144,3434,50,213
십정시장입구,40007,7,3914,5,3914,2,126
십정시장입구,40008,3800,27,3764,27,36,123
십정초등학교(동암의원),40041,1149,709,1118,709,31,59
십정초등학교(동암의원),40042,374,1973,367,1973,7,75
십정초등학교·더샵부평정문,40045,10449,6873,10287,6873,162,558
십정초등학교·더샵부평정문,40048,9619,12893,9486,12893,133,726
쌍마아파트,42112,6510,3202,6282,3202,228,313
쌍마아파트,42114,658,2459,629,2459,29,100
쌍용아파트,37179,5693,2531,5595,2531,98,265
쌍용아파트,37186,1711,3855,1585,3855,126,179
쌍용아파트,37210,558,368,553,368,5,29
쌍용아파트,37228,22246,12544,21868,12544,378,1122
쌍용아파트,37476,14352,23672,14069,23672,283,1226
쌍용아파트,38178,504,774,500,774,4,41
쌍용아파트,38184,926,232,898,232,28,37
쌍용아파트,38469,4854,2733,4702,2733,152,244
쌍용아파트,41434,1343,4492,1316,4492,27,188
쌍용아파트정문,40439,2060,3841,2043,3841,17,190
쌍용자동차인천정비사업소,36144,58,1053,56,1053,2,35
쑥골고가교,37371,3189,3677,3100,3677,89,221
쑥골고가교,37372,6071,8330,5870,8330,201,464
쑥밭다리,43650,37,6,26,6,11,1
쑥밭다리,43683,9,9,7,9,2,0
아나지고개,41001,2625,3145,2524,3145,101,186
아나지고개,41002,3953,6158,3901,6158,52,326
아동보호센터,35680,127,251,119,251,8,12
아동보호센터,35698,49,48,41,48,8,3
아라노을공원·한신더휴,89404,9366,4949,9304,4949,62,461
아라노을공원·한신더휴,89405,6687,9231,6463,9231,224,513
아라동행정복지센터,42465,5682,12809,5612,12809,70,596
아라동행정복지센터,42467,10682,4701,10563,4701,119,496
아라동행정복지센터(서부고용센터),89401,2295,342,2280,342,15,85
아라동행정복지센터(서부고용센터),89402,393,2866,380,2866,13,105
아라뱃길물류센터,89145,3,203,3,203,0,6
아라센트럴파크,89406,1103,3320,1080,3320,23,142
아라센트럴파크,89407,4084,2139,4042,2139,42,200
아름어린이공원,40337,286,361,286,361,0,20
아름어린이공원,40339,492,416,482,416,10,29
아리마을쉼터,37551,12,1034,12,1034,0,33
아리마을쉼터,37552,1419,227,1368,227,51,53
아모텍,39139,1354,2122,1352,2122,2,112
아시아드경기장(공촌사거리)역,42319,2623,4412,2572,4412,51,226
아시아드경기장(공촌사거리)역,42320,410,1712,381,1712,29,68
아시아드대광로제비앙아파트,89257,866,3408,838,3408,28,137
아시아드대광로제비앙아파트,89258,4137,1531,4047,1531,90,182
아암3교사거리,38727,45,150,39,150,6,6
아암3교사거리,38728,179,134,171,134,8,10
아암물류단지,35285,75,0,62,0,13,2
아암물류단지,35590,14,141,3,141,11,5
아울렛(CGV부평),40818,3629,2433,3553,2433,76,195
아이즈빌(부평CGV),40595,13419,8966,13175,8966,244,722
아이즈빌(부평CGV),40598,10569,12884,10357,12884,212,756
아인스월드,55086,814,1631,808,1631,6,78
아주아파트,38047,1598,571,1554,571,44,69
아주아파트,38051,883,1411,858,1411,25,74
아주아파트,38301,1355,958,1344,958,11,74
아주아파트,38304,2312,1363,2294,1363,18,118
아주아파트.미추홀학교,39481,44629,18742,43976,18742,653,2044
아주아파트.미추홀학교,39482,22680,26948,22557,26948,123,1600
아주아파트410동,41575,572,6,571,6,1,18
아침가리마을회관,43287,85,1,70,1,15,2
아침가리마을회관,43867,0,56,0,56,0,1
아쿠아글로리,42811,134,1,134,1,0,4
아현역,22062,4739,29,4737,29,2,153
아현역,23078,31,2588,30,2588,1,84
안골마을입구,38225,9777,10024,9517,10024,260,638
안남고(동보1차아파트),41048,1044,961,1020,961,24,64
안남고등학교,41045,4374,909,4351,909,23,170
안동포교회,42700,590,101,511,101,79,22
안동포교회,42701,57,549,54,549,3,19
안동포사거리,42707,31,198,27,198,4,7
안동포사거리입구,42765,406,56,393,56,13,14
안동포사거리입구,42766,68,765,3,765,65,26
안산마을,43132,54,0,45,0,9,1
안산마을,43138,1,83,1,83,0,2
안산초등학교(구계산고교),41425,16436,13428,16343,13428,93,963
안양대학교,43177,795,519,788,519,7,42
안양대학교,43301,1159,430,1135,430,24,51
안풍산업삼거리,89312,61,2,56,2,5,2
안풍산업삼거리,89329,0,22,0,22,0,0
알앤디써비스,38477,128,1719,124,1719,4,59
알앤디써비스,38478,898,132,882,132,16,33
애관극장,35804,21,63,19,63,2,2
애보박물관,39667,6,27,6,27,0,1
애보박물관,39671,24,19,23,19,1,1
애전마을,43682,7,6,7,6,0,0
애전마을,43894,9,3,9,3,0,0
애전부락,90075,20,138,19,138,1,5
애전부락,90076,115,67,114,67,1,5
앰코코리아(블루오션골프클럽),39880,735,15,734,15,1,24
야곡,43236,85,7,83,7,2,2
야곡,43292,9,65,9,65,0,2
야촌,43210,2,4,2,4,0,0
야촌,43333,0,12,0,12,0,0
약대사거리,57006,4901,997,4896,997,5,190
약대사거리,57010,854,5213,853,5213,1,195
약대주민지원센터.약대초등학교,55080,1067,1917,1034,1917,33,96
약대주민지원센터.약대초등학교,55088,2093,602,2052,602,41,86
약암호텔,80071,476,142,464,142,12,19
약암호텔,80072,54,422,49,422,5,15
얀센백신,38519,196,2,195,2,1,6
얀센백신,38520,3,495,3,495,0,16
양갑리마을회관,90283,18,37,18,37,0,1
양갑리마을회관,90307,27,0,27,0,0,0
양갑리입구,90282,5,3,5,3,0,0
양갑리입구,90308,28,2,28,2,0,0
양곡도매시장,31037,2108,553,2106,553,2,85
양곡버스정류장,80115,199,584,197,584,2,25
양곡사거리.양촌터미널,80116,406,136,400,136,6,17
양골,43987,8,0,7,0,1,0
양골,43989,0,13,0,13,0,0
양구(오상1리),43262,20,98,20,98,0,3
양구(오상1리),43563,119,25,113,25,6,4
양달마을,43910,81,56,80,56,1,4
양달마을,43911,2,0,2,0,0,0
양도,43074,0,29,0,29,0,0
양도,43075,24,20,24,20,0,1
양도면사무소(나무),43912,489,439,473,439,16,29
양도면사무소(쉘터),43913,721,456,671,456,50,37
양도사거리.대림아파트.신안아파트,80076,603,11,596,11,7,19
양도사거리.삼용아파트,80077,56,496,56,496,0,17
양도초등학교,43329,277,167,261,167,16,14
양도초등학교,43568,199,268,193,268,6,15
양로원,40111,546,2434,534,2434,12,96
양로원,40113,2197,470,2154,470,43,86
양사면사무소,43501,13,44,12,44,1,1
양사면사무소,43658,70,70,63,70,7,4
양사우체국,43465,55,25,53,25,2,2
양사우체국,43736,25,34,25,34,0,1
양사초등학교,43466,130,22,122,22,8,4
양사초등학교,43734,16,61,10,61,6,2
양사파출소,43722,13,18,13,18,0,1
양수장,43592,190,1,181,1,9,6
양수장,43781,0,167,0,167,0,5
양오1리마을회관,43454,0,61,0,61,0,1
양오1리마을회관,43666,51,0,45,0,6,1
양오2리경로당,43453,0,88,0,88,0,2
양오2리경로당,43625,22,0,22,0,0,0
양오2리앞,90049,1,24,1,24,0,0
양오리저수지마을,90102,0,23,0,23,0,0
양오리저수지마을,90103,104,0,96,0,8,3
양오저수지입구,90100,0,13,0,13,0,0
양오저수지입구,90101,11,0,9,0,2,0
양왕마을,43927,17,1,17,1,0,0
양왕마을,43928,4,47,4,47,0,1
양재역,31073,17110,4979,17081,4979,29,712
양재역.서초문화예술회관,31008,2835,2916,2832,2916,3,185
양재역.서초문화예술회관,31010,1721,2183,1721,2183,0,125
양재역말죽거리.강남베드로병원,23318,289,204,289,204,0,15
양지공원,38133,5897,4418,5702,4418,195,332
양지촌,43163,10,3,10,3,0,0
양지촌,43342,17,25,16,25,1,1
양진말입구,90056,2,0,2,0,0,0
양진말입구,90057,1,61,1,61,0,2
양촌중학교,41629,689,976,673,976,16,53
양촌중학교,41630,371,441,367,441,4,26
양평해장국,44145,31,18,23,18,8,1
양평해장국,44178,7,22,6,22,1,0
어두,43206,0,13,0,13,0,0
어두,43280,12,0,12,0,0,0
어두마을,43155,149,15,148,15,1,5
어두마을,43322,30,80,29,80,1,3
어류정입구,90175,61,88,60,88,1,4
어류정입구,90176,20,20,16,20,4,1
어류정입구,90312,2,0,1,0,1,0
어류정항,90323,16,0,16,0,0,0
어린이집앞,43402,150,0,136,0,14,4
어린이집앞,43585,10,126,9,126,1,4
에덴하우스,42788,605,2002,575,2002,30,84
에몬스가구,39023,2246,3212,2198,3212,48,176
에몬스가구,39024,3667,1533,3621,1533,46,167
에스틸,89232,212,119,209,119,3,10
에이에프티,39110,1014,2204,990,2204,24,103
에코메트로10단지,39728,562,253,553,253,9,26
에코메트로10단지,39736,153,381,153,381,0,17
에코메트로11단지,39652,2173,2426,2090,2426,83,148
에코메트로11단지후문,39701,751,1590,735,1590,16,75
에코메트로12단지,39651,3750,1739,3674,1739,76,177
에코메트로12단지,39653,29,691,21,691,8,23
에코메트로5단지·논현센트럴뷰,39779,625,1463,596,1463,29,67
에코메트로6단지,39716,3840,271,3715,271,125,132
에코메트로6단지,39758,44,2320,36,2320,8,76
에코메트로7단지,39714,9708,4607,9494,4607,214,461
에코메트로7단지,39715,5159,5643,4922,5643,237,348
에코메트로9단지,39750,7756,1145,7404,1145,352,287
에코메트로9단지,39752,2277,4599,2210,4599,67,221
에코메트로더타워,39711,130,539,118,539,12,21
엑스포빌리지10단지,38460,3024,1408,2934,1408,90,142
엑스포빌리지9단지,38482,3362,7834,3180,7834,182,361
엑슬루타워,37187,3211,8797,3073,8797,138,387
엑슬루타워,42836,3516,14131,3329,14131,187,569
엘리지안타운,42394,2056,1862,1970,1862,86,126
엘아이지식산업센터,39944,315,1062,314,1062,1,44
엘아이지식산업센터(맞은편),92029,658,202,657,202,1,27
엘지슈퍼,39457,1330,1833,1324,1833,6,102
엠파크타워,42025,3857,4646,3823,4646,34,274
엠파크타워,42026,5264,3802,5217,3802,47,292
여고입구,90232,481,480,442,480,39,31
여고입구,90233,738,689,729,689,9,46
여성의광장,38084,3662,4180,3604,4180,58,252
여성의광장,38085,4667,4356,4604,4356,63,291
여우고개,43980,23,107,23,107,0,4
여우고개,43981,42,51,40,51,2,3
여우별펜션,44142,6,12,6,12,0,0
여우별펜션,44179,2,3,2,3,0,0
여우재,35147,411,292,409,292,2,22
여차리,43424,54,64,53,64,1,3
여차리,43472,63,56,62,56,1,3
여차리회관,43505,29,22,26,22,3,1
여차리회관,43525,41,18,35,18,6,1
역삼역.포스코타워역삼,23288,1208,1245,1208,1245,0,79
연락골,39662,0,38,0,38,0,1
연락골,39665,59,9,58,9,1,2
연리입구,43267,48,1,43,1,5,1
연리입구,43614,10,25,10,25,0,1
연미고개,43198,1,114,1,114,0,3
연미고개,43711,85,0,76,0,9,2
연미정,43193,211,4,177,4,34,6
연미정,43621,1,105,1,105,0,3
연성교회,37278,6078,5340,5885,5340,193,368
연세농장,39851,151,6,148,6,3,5
연세대,39725,2435,11057,2414,11057,21,435
연세대,39861,9659,1349,9633,1349,26,355
연세대송도캠퍼스입구,38489,11481,4854,11364,4854,117,526
연세대앞,22022,1,2,1,2,0,0
연세대학교앞,22058,2230,24,2227,24,3,72
연수1동행정복지센터,38248,233,615,226,615,7,27
연수1동행정복지센터,38251,1310,1315,1266,1315,44,84
연수1차아파트,38187,5211,2511,5081,2511,130,249
연수2차아파트,38195,1295,2153,1250,2153,45,111
연수3동행정복지센터,38262,1290,763,1251,763,39,66
연수경찰서,38111,3090,2468,3043,2468,47,179
연수고등학교,38104,630,2692,605,2692,25,107
연수구청,38089,9386,5357,9010,5357,376,475
연수구청,38093,3989,10903,3898,10903,91,480
연수구청입구,38095,4970,4364,4951,4364,19,301
연수꿈담도서관,38103,8315,5228,8084,5228,231,436
연수병원,38296,4881,2692,4782,2692,99,244
연수여자고등학교,38092,2646,4261,2511,4261,135,222
연수역,38506,2168,2323,2121,2323,47,144
연수역,38507,1287,1957,1275,1957,12,104
연수역북측입구,38572,1806,2945,1770,2945,36,153
연수역북측입구,38573,2427,2937,2388,2937,39,173
연수우체국,38280,8067,3673,7728,3673,339,378
연수우체국,38314,1802,973,1711,973,91,89
연수주공3차아파트,38188,3606,4550,3491,4550,115,263
연수중학교,38194,2486,1740,2382,1740,104,136
연수중학교,38196,1051,1356,1030,1356,21,77
연수초등학교,38290,12397,10668,12034,10668,363,744
연수초등학교,38293,4320,4229,4137,4229,183,275
연수한양1차아파트,38091,2422,4656,2377,4656,45,228
연안동행정복지센터,35063,163,11124,152,11124,11,364
연안부두(신선초등학교),35097,1552,3182,1374,3182,178,152
연안부두로삼거리,35754,7,1009,3,1009,4,32
연안부두바다쉼터,35049,1561,25,1528,25,33,51
연안부두어시장,35071,112,8001,101,8001,11,261
연안부두어시장,35072,9607,228,9322,228,285,317
연안아파트,35075,11854,2461,11371,2461,483,461
연안아파트,35076,2424,9931,2325,9931,99,398
연안여객터미널,35057,11461,112,11162,112,299,373
연안여객터미널,35061,65,6840,38,6840,27,222
연안여객터미널,90115,60,67,58,67,2,4
연안여객터미널,90116,39,108,36,108,3,4
연안여객터미널입구,35068,3142,91,3005,91,137,104
연안초등학교,35064,21189,331,20354,331,835,694
연안초등학교,35067,174,14889,158,14889,16,485
연지-기점,90256,2701,2598,2685,2598,16,170
연학초등학교,37137,7283,2026,7215,2026,68,300
연학초등학교,37138,1743,6175,1693,6175,50,255
연합의원,42186,4686,2134,4571,2134,115,220
연화중학교,38117,2845,3400,2808,3400,37,201
연흥아파트,37567,3350,5054,3286,5054,64,271
연흥아파트,37568,2733,6260,2643,6260,90,290
연희공원,42950,99,199,98,199,1,9
연희동광명아파트(사계절썰매장),42314,1884,2087,1849,2087,35,128
연희동광명아파트(사계절썰매장),42599,1799,2201,1745,2201,54,129
연희동행정복지센터,42311,1005,1772,965,1772,40,89
연희동행정복지센터,42312,2066,1289,2000,1289,66,108
열우물보조경기장주차장,40916,196,72,122,72,74,8
열우물사거리,40052,9,313,8,313,1,10
열우물전통시장,40028,365,2589,352,2589,13,95
열우물전통시장,40030,2382,382,2307,382,75,89
열우물전통시장입구,40036,2360,385,2320,385,40,88
열우물전통시장입구,40038,255,3700,246,3700,9,127
열우물테니스경기장,40053,4251,3700,4197,3700,54,256
열우물테니스경기장,40054,1014,1212,1001,1212,13,71
열우물테니스경기장,40063,428,1101,416,1101,12,49
열우물테니스경기장,40064,288,683,276,683,12,31
열우물테니스경기장,42023,4956,4799,4906,4799,50,314
열우물테니스경기장,42024,2895,2981,2846,2981,49,189
영골,43954,3,0,3,0,0,0
영골,43955,0,14,0,14,0,0
영남1단지.고합아파트,70164,233,232,227,232,6,15
영남아파트,37060,5277,4095,5171,4095,106,302
영남아파트,37063,5726,5495,5560,5495,166,361
영남아파트,38203,2693,1493,2650,1493,43,135
영남아파트,38205,896,3099,873,3099,23,128
영림몰딩도어,39943,53,185,53,185,0,7
영림산업,39028,870,3897,858,3897,12,153
영림임업,39026,1128,3271,1125,3271,3,141
영사목장 앞,90390,1,11,1,11,0,0
영사목장 앞,90391,8,10,8,10,0,0
영선고등학교,40853,6,1008,2,1008,4,32
영은교회,43037,50,35,47,35,3,2
영은교회,43139,18,143,18,143,0,5
영은슈퍼,89052,315,829,307,829,8,36
영은슈퍼,89064,819,8,774,8,45,26
영음교회.효성해링턴플레이스,41422,1663,2307,1645,2307,18,128
영종KCC스위첸.한양수자인,35449,492,1862,424,1862,68,75
영종KCC스위첸옆문,35755,598,7605,552,7605,46,264
영종KCC스위첸옆문,35756,7923,548,7833,548,90,273
영종LH2단지,35483,796,797,780,797,16,51
영종LH67단지,35872,42,56,42,56,0,3
영종LH67단지,35873,76,60,74,60,2,4
영종LH아파트입구,35390,82,46,79,46,3,4
영종e편한세상센텀베뉴·센트럴푸르지오자이,35660,4099,4033,4018,4033,81,262
영종고등학교,35493,2571,2601,2476,2601,95,166
영종고등학교,35496,2094,2238,1966,2238,128,139
영종공원묘지입구,35626,13,29,13,29,0,1
영종공원묘지입구,35627,3,9,2,9,1,0
영종교회,35306,215,282,199,282,16,16
영종교회,35545,1045,761,1022,761,23,58
영종대교휴게소,42942,1,138,1,138,0,4
영종대교휴게소,42943,108,16,108,16,0,4
영종동행정복지센터,35672,151,205,147,205,4,11
영종동행정복지센터,35673,36,51,35,51,1,2
영종물류고등학교·영종자이아파트,35314,4598,4806,4372,4806,226,303
영종물류고등학교앞·영종자이아파트,35307,7000,3787,6643,3787,357,347
영종버스공영차고지,35837,106,3,20,3,86,3
영종버스공영차고지,35838,75,55,7,55,68,4
영종블루오션,35819,211,122,198,122,13,10
영종블루오션,35820,55,380,53,380,2,14
영종선착장입구,35833,2109,1812,2055,1812,54,126
영종선착장입구,35834,22,225,13,225,9,7
영종성당.정도사,35850,1,38,1,38,0,1
영종성당.정도사,35851,10,11,10,11,0,0
영종센트럴푸르지오자이·e편한세상센텀베뉴,35661,4559,2785,4457,2785,102,236
영종소방서,35765,2,9,2,9,0,0
영종아레나,35830,164,2,154,2,10,5
영종아레나,35831,10,101,0,101,10,3
영종역,35566,37293,652,36828,652,465,1224
영종역,35567,15133,12034,14927,12034,206,876
영종역(2번출구),35870,28,1620,28,1620,0,53
영종역(청라행),35620,72,11841,72,11841,0,384
영종역사관,35624,264,166,260,166,4,13
영종역사관,35625,92,364,85,364,7,14
영종유승한내들스카이스테이,35759,3385,1702,3307,1702,78,164
영종유승한내들스카이스테이,35760,1277,1852,1249,1852,28,100
영종자이아파트,35835,45,126,44,126,1,5
영종자이아파트,35836,460,88,458,88,2,17
영종장로교회,35580,52,63,48,63,4,3
영종장로교회,35581,44,33,42,33,2,2
영종주공7단지,35111,1673,1064,1597,1064,76,88
영종주야간보호센터,35854,11,18,11,18,0,0
영종주야간보호센터,35855,10,3,10,3,0,0
영종중학교,35463,2232,2820,2055,2820,177,162
영종중학교,35464,5278,1561,4884,1561,394,220
영종진공원,35276,966,322,916,322,50,41
영종진공원,35279,176,1639,176,1639,0,58
영종풍림아이원1차,35110,4,216,4,216,0,7
영종하늘도서관,35585,1025,1114,991,1114,34,69
영종하늘도서관,35586,1049,1270,1009,1270,40,74
영진아파트,40551,219,526,197,526,22,24
영창한의원,40452,7390,5108,7225,5108,165,403
영풍아파트,36040,10213,3302,10004,3302,209,435
영풍아파트,39546,28,373,28,373,0,12
영흥대교입구,44100,1,4,1,4,0,0
영흥대교입구,44180,3,4,3,4,0,0
영흥면사무소,44131,0,1,0,1,0,0
영흥면사무소,44181,40,5,40,5,0,1
영흥버스터미널,44004,5753,4795,5432,4795,321,340
영흥버스터미널,44116,174,25,156,25,18,6
영흥빌라,44182,7,1,7,1,0,0
영흥수협공판장입구,44009,466,7,456,7,10,15
영흥수협공판장입구,44010,8,700,4,700,4,22
영흥어린이집,44137,13,32,12,32,1,1
영흥우체국,44107,15,29,11,29,4,1
영흥우체국,44183,33,13,31,13,2,1
영흥종합운동장앞,44120,4,27,4,27,0,1
영흥종합운동장앞,44192,39,3,37,3,2,1
영흥초교입구,44101,27,7,26,7,1,1
영흥초교입구,44184,3,13,2,13,1,0
영흥칼국수,44136,1,2,1,2,0,0
영흥플로레도커피,44144,10,10,9,10,1,0
영흥플로레도커피,44185,8,23,7,23,1,1
예단포,35319,131,428,130,428,1,18
예단포,35395,393,79,386,79,7,15
예단포물양장,35622,556,317,515,317,41,28
예단포물양장,35623,78,147,77,147,1,7
예드림빌라입구,35546,73,9,69,9,4,2
예드림빌라입구,35547,31,69,31,69,0,3
예림임업,39053,54,290,54,290,0,11
예림임업,39054,165,132,164,132,1,9
예비군교육장,41272,972,1460,960,1460,12,78
예비군교육장,41273,1865,3024,1852,3024,13,157
예비군교육장입구,90010,29,6,28,6,1,1
예비군교육장입구,90011,4,22,4,22,0,0
예비군훈련장,43201,240,5,238,5,2,7
예비군훈련장,43315,5,200,5,200,0,6
예송중학교,38592,1659,1500,1626,1500,33,101
예송중학교,38593,2676,1571,2471,1571,205,137
예술회관사거리,37254,4417,8023,4342,8023,75,401
예술회관역,39206,3835,11024,3785,11024,50,479
예술회관역(4번출구),39207,5283,5540,5209,5540,74,349
예원앞,41499,26,109,26,109,0,4
예원앞,41515,68,0,68,0,0,2
옐림교회,40854,5622,4966,5594,4966,28,341
옐림교회앞,35684,68,23,67,23,1,2
옐림교회앞,35694,24,41,20,41,4,2
오공본드,39108,4231,3628,4151,3628,80,253
오관물입구,35859,0,1,0,1,0,0
오관물입구,35860,15,0,15,0,0,0
오두돈대,43361,61,14,58,14,3,2
오두돈대,43536,14,50,14,50,0,2
오두리(넙성입구),43638,17,10,17,10,0,0
오두리(넙성입구),43675,2,63,2,63,0,2
오두리종점,43137,79,1,74,1,5,2
오두리종점,43529,3,56,3,56,0,1
오두마을입구,43557,50,6,48,6,2,1
오두마을입구,43647,0,25,0,25,0,0
오라니마을,80360,66,92,65,92,1,5
오류골,43013,284,143,280,143,4,13
오류골,43014,77,256,76,256,1,10
오류내,43389,30,417,30,417,0,14
오류내,43757,538,49,496,49,42,18
오류동마을,41353,1786,775,1761,775,25,82
오류동마을,41354,1035,4003,1019,4003,16,162
오류동역입구,89058,0,9,0,9,0,0
오류동역입구,89066,12,173,12,173,0,5
오리정,80125,767,135,737,135,30,29
오리정,80126,98,603,95,603,3,22
오상리고인들,43265,21,6,21,6,0,0
오상리고인들,43379,0,18,0,18,0,0
오상입구,43119,36,5,31,5,5,1
오상입구,43120,0,18,0,18,0,0
오상입구,43390,2,94,1,94,1,3
오상입구,43565,104,3,91,3,13,3
오성교회,43555,15,0,13,0,2,0
오성교회,43853,1,26,1,26,0,0
오성아파트,40480,5941,2050,5710,2050,231,257
오성아파트,40487,1848,4809,1792,4809,56,214
오성아파트,40493,392,1905,381,1905,11,74
오성아파트,40721,211,334,195,334,16,17
오성정밀,39490,712,1012,704,1012,8,55
오이도역,70031,892,6782,875,6782,17,247
오이도역,70032,6543,853,6458,853,85,238
오정휴먼시아(중),57044,220,2105,215,2105,5,75
오정휴먼시아(중),57045,2152,292,2139,292,13,78
오조산공원,41246,1977,1177,1940,1177,37,101
오조산공원,41249,2940,3219,2805,3219,135,198
오조산공원,41621,43,375,16,375,27,13
옥골.옥토끼우주센터,43033,160,164,155,164,5,10
옥골.옥토끼우주센터,43561,118,94,115,94,3,6
옥골사거리,38731,486,3548,450,3548,36,130
옥골사거리,38732,606,191,569,191,37,25
옥금말,43952,111,43,67,43,44,4
옥금말,43953,32,80,31,80,1,3
옥련1동행정복지센터,38217,9192,6149,9111,6149,81,494
옥련2동행정복지센터(옥련우체국),38450,2831,57,2754,57,77,93
옥련2동행정복지센터(옥련우체국),38451,1307,2574,1275,2574,32,125
옥련고개,38212,1856,3861,1817,3861,39,184
옥련고개,38219,1687,1248,1619,1248,68,94
옥련동성당,38330,864,2134,840,2134,24,96
옥련사거리,38170,899,1154,871,1154,28,66
옥련사거리,38171,1649,802,1526,802,123,79
옥련여고입구,38271,823,779,804,779,19,51
옥련여고입구,38273,1033,2538,992,2538,41,115
옥련중학교,38470,7309,4765,7027,4765,282,389
옥련지구대,38223,1422,4283,1322,4283,100,184
옥련초등학교,38146,4148,4495,3997,4495,151,278
옥림교회,43202,38,0,32,0,6,1
옥림교회,43716,1,43,1,43,0,1
옥림슈퍼,43205,210,7,209,7,1,7
옥림슈퍼,43720,39,93,39,93,0,4
온누리병원,42425,264,1087,243,1087,21,43
온수교차로,90231,5,155,5,155,0,5
온수리,43018,6513,2168,6161,2168,352,280
온수리,43020,3738,5500,3493,5500,245,298
온수시장,43019,61,30,57,30,4,2
온수시장,43095,38,432,30,432,8,15
올리브백화점,39359,4239,1745,4191,1745,48,193
올리브백화점,39363,1994,2522,1949,2522,45,145
올리브백화점,39364,15384,14649,15099,14649,285,968
올리브백화점,39589,17914,19153,17622,19153,292,1195
올리브백화점,39746,17255,19321,17052,19321,203,1179
올리브백화점,39747,24305,28563,24072,28563,233,1705
올림픽공원,39209,3091,4797,3072,4797,19,254
올림픽공원,39210,349,798,339,798,10,37
올림픽생활기념관,39349,4762,6283,4697,6283,65,356
옹장골,43171,10,95,10,95,0,3
옹장골,43230,137,8,134,8,3,4
옹진군청,37019,1227,2293,1201,2293,26,113
옹진군청,37020,9045,1370,8829,1370,216,335
완정공단입구,42409,6110,4113,5893,4113,217,329
완정사거리,42561,22048,8297,21836,8297,212,978
완정사거리,42562,280,1298,222,1298,58,50
완정역,42673,13142,29144,12904,29144,238,1364
완정역,42674,7320,17204,7187,17204,133,791
완정초등학교.검단도서관,42414,3849,6306,3712,6306,137,327
완정초등학교.검단도서관,42415,5137,5670,4825,5670,312,348
왕궁가든,41289,1882,2369,1859,2369,23,137
왕궁가든,41291,2264,2965,2190,2965,74,168
왕길고가,42551,1217,38,1182,38,35,40
왕길고가,42552,12,1195,6,1195,6,38
왕길동,42386,25,289,19,289,6,10
왕길동,42387,78,143,73,143,5,7
왕길동(기점),42699,1031,11,948,11,83,33
왕길동종점,42594,296,480,15,480,281,25
왕길역,89199,331,115,312,115,19,14
왕길역,89200,148,563,138,563,10,22
왕리물,90098,5,5,1,5,4,0
왕리물,90099,0,1,0,1,0,0
왕산골,35490,47,14,47,14,0,1
왕산골,35491,28,68,28,68,0,3
왕산교,35632,26,79,26,79,0,3
왕산교,35633,4,42,4,42,0,1
왕산차고지,35403,783,166,762,166,21,30
왕산차고지,35720,155,9,145,9,10,5
왕산해수욕장(왕산요트경기장),35020,1522,193,1506,193,16,55
왕산해수욕장(왕산요트경기장),35021,230,1280,213,1280,17,48
외1리마을회관앞,44096,48,44,40,44,8,2
외1리마을회관앞,44186,6,2,6,2,0,0
외1리소장골,44133,82,59,81,59,1,4
외뜰,43687,15,10,15,10,0,0
외뜰,43745,9,17,9,17,0,0
외리보건지소앞,44095,18,28,17,28,1,1
외주,43181,80,11,79,11,1,2
외주,43241,9,71,9,71,0,2
외포1리,43283,12,92,10,92,2,3
외포고개,43244,96,103,90,103,6,6
외포고개,43366,3,116,3,116,0,3
외포리,43556,1662,1732,1558,1732,104,109
외포리(싱싱마트),90376,69,26,65,26,4,3
외포리(하나로마트),90387,0,96,0,96,0,3
외포리(하나로마트),90388,111,39,104,39,7,4
외포리소공원,90127,65,15,63,15,2,2
외포리소공원,90128,0,53,0,53,0,1
외포리정미소,43240,90,7,85,7,5,3
외포삼거리,43110,361,119,343,119,18,15
외포삼거리,43285,0,56,0,56,0,1
요곡,43655,138,164,129,164,9,9
요곡,43762,64,28,59,28,5,2
요골,43590,76,1,75,1,1,2
요골,43780,0,12,0,12,0,0
용갈비,40338,66,2546,64,2546,2,84
용구물길,90385,0,16,0,16,0,0
용구물길,90386,17,0,16,0,1,0
용궁사입구,35578,128,615,127,615,1,23
용궁사입구,35579,514,57,500,57,14,18
용남시장,37232,18195,15649,17765,15649,430,1091
용남시장,37236,18866,19105,18346,19105,520,1224
용남파출소,37177,7058,2093,6952,2093,106,295
용남파출소,37184,3636,10078,3563,10078,73,442
용담공원,38172,1371,2032,1358,2032,13,109
용담공원,38177,2022,1435,1962,1435,60,111
용담마을,38191,5484,5829,5328,5829,156,364
용담마을,38192,5236,3280,5103,3280,133,274
용담바다낚시터,44132,1,1,1,1,0,0
용담바다낚시터,44188,2,0,2,0,0,0
용담어촌계앞,44097,14,6,12,6,2,0
용담어촌계앞,44189,6,0,6,0,0,0
용당사터,43537,37,1,37,1,0,1
용당사터,43677,1,24,1,24,0,0
용유동행정복지센터,35017,132,57,122,57,10,6
용유동행정복지센터,35211,61,224,61,224,0,9
용유동행정복지센터,35411,128,216,124,216,4,11
용유동행정복지센터,35412,183,92,174,92,9,8
용유역,35433,38,121,36,121,2,5
용유초등학교,35022,294,32,281,32,13,10
용유초등학교,35023,30,318,29,318,1,11
용유초등학교,35409,43,405,31,405,12,14
용유초등학교삼거리,35410,384,59,374,59,10,14
용일사거리,37208,30003,23083,29672,23083,331,1712
용일사거리,37218,28326,28727,27830,28727,496,1840
용일사거리,37251,1291,1554,1256,1554,35,91
용일초등학교,37233,12421,8665,12246,8665,175,680
용일초등학교,37237,8735,16324,8420,16324,315,808
용정리 사거리,43721,0,211,0,211,0,6
용정마을회관,43370,0,53,0,53,0,1
용정마을회관,43615,324,0,290,0,34,10
용정초등학교,37297,1305,696,1280,696,25,64
용정초등학교,37299,619,2349,612,2349,7,95
용진주택,43084,230,59,223,59,7,9
용진주택,43085,8,22,8,22,0,0
용진진,43639,4,14,4,14,0,0
용진진,43678,7,4,5,4,2,0
용현2동행정복지센터,37653,1446,150,1419,150,27,51
용현2동행정복지센터,37654,327,1531,218,1531,109,59
용현3동행정복지센터.보훈병원,37221,22972,17064,22460,17064,512,1291
용현3동행정복지센터.보훈병원,37224,12264,13194,12023,13194,241,821
용현5동행정복지센터,37129,262,893,260,893,2,37
용현고가교,37550,109,1929,101,1929,8,65
용현고가교,37611,7691,1562,7660,1562,31,298
용현고개,37178,3831,3881,3716,3881,115,248
용현고개,37497,4131,5325,4063,5325,68,305
용현동농협,37117,527,3359,520,3359,7,125
용현동상우빌라,37564,2,735,2,735,0,23
용현동상우빌라,37565,1360,53,1299,53,61,45
용현동성원상떼빌아파트,37546,434,446,419,446,15,28
용현사거리,37212,1537,1299,1478,1299,59,91
용현사거리,37213,1358,3995,1282,3995,76,172
용현시장,37227,24295,28404,23642,28404,653,1699
용현시장,37230,26100,15004,25523,15004,577,1325
용현시장,37268,5525,3467,5339,3467,186,290
용현시장,37270,4512,5522,4338,5522,174,323
용현아파트,37153,15,380,15,380,0,12
용현중학교,37021,3134,618,3087,618,47,121
용현중학교,37028,1183,2838,1136,2838,47,129
용현초등학교,37508,3,875,2,875,1,28
용현초등학교입구,37128,12006,3571,11772,3571,234,502
용현초등학교입구,37134,6726,13443,6532,13443,194,650
용화사(길상낚시터),90077,11,37,9,37,2,1
용화사(길상낚시터),90080,75,41,74,41,1,3
우뢰촌,43425,176,90,173,90,3,8
우뢰촌,43792,104,70,96,70,8,5
우리자동차,35223,980,246,790,246,190,39
우림라이온스밸리,40592,369,5165,364,5165,5,178
우림라이온스밸리,40594,9900,1222,9812,1222,88,358
우림필유아파트,42924,2927,1782,2870,1782,57,151
우림필유아파트,42925,1409,2787,1376,2787,33,135
우물골,43929,23,5,23,5,0,0
우물골,43930,3,17,2,17,1,0
우미린1단지정문,35583,2994,881,2942,881,52,125
우미린1단지정문,35584,1055,2953,1041,2953,14,129
우미린1단지후문,35461,1357,4707,1325,4707,32,195
우미린1단지후문,35462,5291,830,5254,830,37,197
우미린2단지정문,35512,4102,1670,4011,1670,91,186
우미린2단지정문,35513,2977,4731,2895,4731,82,248
우미린2단지후문,35454,2906,1700,2764,1700,142,148
우미린더시그니처(후문),89443,3687,335,3680,335,7,129
우성1차아파트,38094,4347,4547,4203,4547,144,286
우성1차아파트,39834,301,39,294,39,7,10
우성2차아파트(옥련동),38356,2583,944,2533,944,50,113
우성2차아파트·원인재역(4번출구),38150,2887,6380,2850,6380,37,298
우성4차,40185,8197,242,8036,242,161,272
우성4차,40187,178,7276,175,7276,3,240
우성4차후문,40730,186,3128,181,3128,5,106
우성4차후문,40731,3804,276,3736,276,68,131
우성아파트,38143,4428,2119,4349,2119,79,211
우성아파트,38357,1446,2416,1409,2416,37,124
우성아파트,40341,728,1228,719,1228,9,63
우성아파트,42717,2692,4557,2675,4557,17,233
우성아파트,42718,1609,2361,1580,2361,29,128
우성아파트.은행교회,70026,656,26,630,26,26,22
우저서원(대성주유소),35214,151,81,147,81,4,7
우저서원(대성주유소),35215,41,682,41,682,0,23
우주골드타운빌라,40863,645,1189,634,1189,11,59
우주골드타운빌라,40864,425,1191,424,1191,1,52
우주아파트,38252,8025,9350,7835,9350,190,560
우진기계,89106,30,307,30,307,0,10
우진아파트,37158,1968,2257,1902,2257,66,136
우진아파트,37159,516,2771,497,2771,19,106
우체국사거리,39694,918,1454,882,1454,36,76
우체국사거리,39695,1711,859,1615,859,96,82
우체국사거리,39704,2530,3895,2393,3895,137,207
욱일아파트후문,40877,1490,2124,1485,2124,5,116
운남교차로,35435,68,173,56,173,12,7
운남교차로,35444,119,100,118,100,1,7
운남교차로,35524,100,30,96,30,4,4
운남교차로,35582,11,47,10,47,1,1
운남교차로 입구,35839,9,12,9,12,0,0
운남교차로 입구,35840,51,8,43,8,8,1
운남교차로.잔다리,35595,589,252,579,252,10,27
운남교차로.잔다리,35596,224,661,216,661,8,28
운남동,35268,134,268,124,268,10,12
운남동,35281,276,343,276,343,0,19
운남동우체국,35848,236,144,230,144,6,12
운남동우체국,35849,148,308,133,308,15,14
운남초교사거리,35706,26,131,26,131,0,5
운남초교사거리,35707,418,250,408,250,10,21
운북공영차고지,35779,344,3,326,3,18,11
운북공영차고지,35783,7,309,5,309,2,10
운서SKVIEW 스카이시티,35780,0,1,0,1,0,0
운서SKVIEW·세계로향하는교회,35781,0,3,0,3,0,0
운서역,35242,24316,14219,23894,14219,422,1243
운서역,35257,8128,15600,7958,15600,170,765
운서역(남동측),35775,5,26,3,26,2,1
운서역(남동측),35776,36,47,36,47,0,2
운서역(하워드존슨호텔),35747,2699,4528,2666,4528,33,233
운서역금강펜테리움아파트,35482,549,672,539,672,10,39
운서초등학교,35270,5648,2310,5525,2310,123,256
운서초등학교,35282,2632,3367,2478,3367,154,193
운양역,80348,270,303,269,303,1,18
운양역,80351,271,88,267,88,4,11
운연동,39374,653,730,629,730,24,44
운연동,39379,725,690,696,690,29,45
운연동,39673,51,0,50,0,1,1
운연삼거리,39987,648,1800,619,1800,29,78
운연삼거리,39988,117,678,105,678,12,25
운연역,39954,11529,11517,11457,11517,72,743
운연역,92026,6797,7684,6773,7684,24,467
운연천,92027,336,923,332,923,4,40
운연천,92028,416,191,416,191,0,19
운전면허시험장,39005,2399,687,2332,687,67,99
울레기,43179,13,224,13,224,0,7
울레기,43548,237,25,226,25,11,8
웃말,90169,16,22,16,22,0,1
웃말,90170,36,12,36,12,0,1
원당고등학교,42459,3234,3470,3160,3470,74,216
원당사거리.검단선사박물관,42446,20557,8093,20289,8093,268,924
원당사거리.검단선사박물관,42447,11700,19792,11525,19792,175,1015
원당중고등학교,42460,86,228,84,228,2,10
원당중고등학교,42462,151,305,151,305,0,14
원동초등학교,39656,1900,7685,1766,7685,134,309
원동초등학교,39657,11355,2099,11120,2099,235,434
원성골,35434,63,202,59,202,4,8
원성골,35445,96,248,92,248,4,11
원수리마을,90251,7,4,7,4,0,0
원수리마을,90252,9,3,9,3,0,0
원인재역(1번출구),38162,2197,7921,2171,7921,26,326
원인재역(4번출구),38153,9608,2821,9568,2821,40,400
원인재역(6번출구),38166,8124,2638,8067,2638,57,347
원적산터널,40821,1205,3755,1135,3755,70,160
원적산터널,40822,1755,3044,1732,3044,23,154
원적산터널서측,42666,6376,4393,6222,4393,154,347
원적산터널서측,42667,3977,4368,3901,4368,76,269
원종IC(중),57046,35,3425,31,3425,4,111
원종IC(중),57047,1007,79,992,79,15,35
원진운수차고지,89003,678,7,657,7,21,22
원진운수차고지,89004,60,675,10,675,50,23
원창동(기점),89143,2958,17,2831,17,127,95
원창동(기점),89144,89,2425,9,2425,80,81
원창동(종점),42183,15,1025,3,1025,12,33
원창동(종점),42184,579,21,512,21,67,19
원흥아파트,38131,26242,16968,25648,16968,594,1393
원흥아파트,38336,35955,22527,35162,22527,793,1886
원흥아파트,42793,79,8,79,8,0,2
월곳삼거리,43188,0,47,0,47,0,1
월곳삼거리,43619,68,0,68,0,0,2
월곶,70002,186,6,95,6,91,6
월곶동주민센터.월곶포구,70006,965,169,944,169,21,36
월곶동주민센터.월곶포구,70005,218,1397,214,1397,4,52
월곶풍림아파트3차,70030,51,92,39,92,12,4
월드메르디앙아파트,42161,4580,4721,4414,4721,166,300
월드메르디앙아파트,42163,6448,3663,6318,3663,130,326
월드아파트,42499,7824,9823,7737,9823,87,569
월드아파트,42500,12098,6241,11990,6241,108,591
월미공원,35138,96,1106,91,1106,5,38
월미공원,35572,275,51,266,51,9,10
월미공원역,35345,232,5361,203,5361,29,180
월미공원역,35346,8016,422,7819,422,197,272
월미도,35148,49599,465,47851,465,1748,1614
월미도(시티투어),35144,1382,21550,1289,21550,93,739
월미도문화관,35558,2141,66,2057,66,84,71
월미도종점,35368,364,9429,233,9429,131,315
월미문화의거리,35132,28,4762,20,4762,8,154
월미문화의거리,35219,3267,27,3159,27,108,106
월미테마파크,35128,184,18480,177,18480,7,602
월미테마파크,35502,10202,78,9777,78,425,331
월선포,90040,116,135,86,135,30,8
월선포,90041,63,8,61,8,2,2
웨딩타운,22061,193,1,193,1,0,6
웨딩타운,23077,1,34,1,34,0,1
웰카운티,38352,1262,6638,1203,6638,59,254
웰카운티,38353,13335,1610,12718,1610,617,482
웰카운티,42772,1594,4473,1482,4473,112,195
웰카운티17단지,89182,3330,862,3281,862,49,135
웰카운티17단지,89183,718,2598,679,2598,39,106
웰카운티1단지,38648,881,2128,846,2128,35,97
웰카운티1차,42746,2000,1191,1990,1191,10,102
웰카운티1차,42764,1838,1344,1795,1344,43,102
웰카운티2단지,38709,526,721,516,721,10,40
웰카운티4단지,38446,962,164,920,164,42,36
웰카운티4단지,38447,164,1581,160,1581,4,56
윗말,43488,14,7,13,7,1,0
윗말,43839,4,4,3,4,1,0
윗망월,43335,0,100,0,100,0,3
윗망월,43578,156,2,153,2,3,5
유니온프라자,42113,12354,7931,12193,7931,161,654
유림골프장,41469,984,5,972,5,12,31
유성아파트,43086,94,731,94,731,0,26
유성아파트,43087,756,45,748,45,8,25
유수지,39010,626,693,612,693,14,42
유수지,39011,498,2185,495,2185,3,86
유수지근린공원,39019,1046,826,1035,826,11,60
유수지근린공원,39020,729,840,727,840,2,50
유수지길,39003,1020,2203,1006,2203,14,103
유수지길,39004,1404,914,1396,914,8,74
유승아파트,42397,2113,453,2074,453,39,82
유승아파트,42398,345,1904,333,1904,12,72
유승아파트(삼성홈타운아파트),41003,4152,3319,4062,3319,90,241
유승아파트(삼성홈타운아파트),41004,3830,3695,3746,3695,84,242
유승아파트(삼성홈타운아파트),41005,6846,2352,6669,2352,177,296
유승아파트(삼성홈타운아파트),41006,1843,6768,1786,6768,57,277
유승아파트(삼성홈타운아파트),41583,4,316,4,316,0,10
유원아파트,37163,6411,10480,6199,10480,212,544
유원아파트,37172,13928,4993,13669,4993,259,610
유진시스템앞,40676,1038,4833,1030,4833,8,189
유진시스템앞,40678,2161,1323,2119,1323,42,112
유천아파트,38254,862,840,828,840,34,54
유천아파트,38266,7833,4920,7706,4920,127,411
유천아파트후문,38265,273,829,266,829,7,35
유현마을.신동아아파트,80001,108,194,107,194,1,9
유현마을.신동아아파트,80073,282,8,281,8,1,9
유현사거리,42484,6158,10123,6111,10123,47,525
유현사거리,42487,9385,4678,9316,4678,69,453
유호엔시티.논현푸르지오,39823,52,1794,44,1794,8,59
육골,18805,4,112,0,112,4,3
육골,62030,3,4,1,4,2,0
윤성아파트,38307,254,1875,251,1875,3,68
윤성아파트(인항고교),37011,5857,5181,5688,5181,169,356
윤성아파트(인항고교),37012,4558,2241,4429,2241,129,219
율도근린공원,89339,362,55,353,55,9,13
율도근린공원,89340,697,1286,686,1286,11,63
율도근린공원입구,89428,180,122,175,122,5,9
율도근린공원입구,89429,139,102,139,102,0,7
율도입구,42188,1375,1248,1338,1248,37,84
율도입구,42190,1009,1104,993,1104,16,68
율목동행정복지센터,35787,23,84,19,84,4,3
율목동행정복지센터,35801,166,31,147,31,19,6
율목오거리,35786,41,46,39,46,2,2
율목오거리,35802,82,24,77,24,5,3
율생리입구,80016,205,971,203,971,2,37
율생리입구,80017,1139,220,1082,220,57,43
은계초등학교.사랑스러운교회,70025,1632,32,1577,32,55,53
은골공원,35599,1454,2464,1440,2464,14,126
은골공원,35600,2391,1672,2265,1672,126,131
은골사거리,35309,256,229,239,229,17,15
은당골,90212,26,24,25,24,1,1
은당골,90213,18,22,18,22,0,1
은봉초등학교,39613,12716,3105,12332,3105,384,510
은봉초등학교,39614,3171,14418,3020,14418,151,567
은성아파트,39321,8021,3699,7857,3699,164,378
은성프레미오,39325,1867,5211,1814,5211,53,228
은영빌라,41089,1971,116,1956,116,15,67
은영아파트,42218,4190,4024,4045,4024,145,264
은지초등학교사거리,42365,4708,5312,4630,5312,78,323
은하마을.중흥마을,55069,447,1604,431,1604,16,66
은하목장앞,43274,1,2,1,2,0,0
은하목장앞,43852,1,5,1,5,0,0
은하쌍용아파트,55062,1271,6154,1255,6154,16,239
은행마을,41198,9254,3154,9104,3154,150,400
은행초등학교,70019,2958,557,2902,557,56,113
을왕리해수욕장,35009,8275,836,8060,836,215,293
을왕리해수욕장,35010,911,9511,886,9511,25,336
을왕리해수욕장.더위크앤리조트,35015,3459,478,3404,478,55,127
을왕리해수욕장.더위크앤리조트,35016,562,2803,554,2803,8,108
읍내리마을회관입구,90032,0,60,0,60,0,1
읍내리마을회관입구,90033,112,1,86,1,26,3
응곡,43696,45,27,44,27,1,2
응곡,43749,29,43,26,43,3,2
이강리방앗간,43691,107,2,98,2,9,3
이강리방앗간,43832,7,207,5,207,2,6
이건창생가,43145,46,2,36,2,10,1
이건창생가,43434,3,46,2,46,1,1
이규보묘입구,90065,72,56,59,56,13,4
이규보묘입구,90389,73,66,68,66,5,4
이대역,22015,5694,86,5691,86,3,186
이대역,22057,3549,45,3544,45,5,115
이대역,23036,55,7411,55,7411,0,240
이마트,41122,5987,18927,5844,18927,143,803
이마트,41125,27073,10754,26833,10754,240,1220
이마트송림점,36098,5523,8177,5445,8177,78,441
이마트송림점,36100,8661,5792,8572,5792,89,466
이안송도,38409,21649,6217,21320,6217,329,898
이영화학,39644,2808,997,2723,997,85,122
이촌,43768,2,0,2,0,0,0
이토상가,39196,8043,2088,7882,2088,161,326
이현(이강리교회),43661,12,144,11,144,1,5
이현(이강리교회),43690,158,8,131,8,27,5
이화1동입구,41487,143,124,143,124,0,8
이화1동입구,41506,31,0,31,0,0,1
이화2동마을회관,41484,2,10,2,10,0,0
이화2동마을회관,41504,109,37,105,37,4,4
이화2동회차지,41486,22,21,22,21,0,1
이화교회앞,41489,47,60,47,60,0,3
이화동노인정,41490,202,107,195,107,7,9
이화동다리,41479,87,152,79,152,8,7
이화동다리,41516,325,15,325,15,0,10
이화진등마을경로당,41601,39,39,39,39,0,2
인고앞,37318,4231,6676,4050,6676,181,351
인고앞,37338,7496,4765,7307,4765,189,395
인고체육관,37305,9651,5139,9451,5139,200,477
인고체육관(동양장사거리),37309,8818,8688,8629,8688,189,564
인내마을,90181,29,31,29,31,0,1
인내마을,90182,25,11,25,11,0,1
인명여자고등학교,37199,35165,6821,34653,6821,512,1354
인명여자고등학교,37205,9877,46221,9651,46221,226,1809
인사리군부대앞,90268,24,17,24,17,0,1
인사리군부대앞,90270,2,0,2,0,0,0
인사리마을회관,90267,0,33,0,33,0,1
인사리마을회관,90271,11,2,11,2,0,0
인사리우무렛골,90266,9,47,9,47,0,1
인사리인현경로당앞,90269,42,25,42,25,0,2
인사리지석교회,90272,9,9,9,9,0,0
인산저수지,43354,81,76,79,76,2,5
인산저수지,43575,38,90,37,90,1,4
인삼농협앞,80305,20,248,17,248,3,8
인삼농협앞,80306,400,17,377,17,23,13
인성여자고등학교,35793,155,754,131,754,24,29
인성여자고등학교,35808,49,461,49,461,0,16
인송빌라,40241,3141,35,3093,35,48,102
인수초등학교,39386,11613,10357,11517,10357,96,708
인수초등학교,39392,14777,12743,14677,12743,100,887
인썸호텔,44134,82,61,72,61,10,4
인아교회,35091,1134,161,1065,161,69,41
인아교회,35094,180,1108,172,1108,8,41
인재개발원,42281,1177,2242,1134,2242,43,110
인재개발원,42282,2406,1327,2352,1327,54,120
인제고등학교,39548,330,1311,322,1311,8,52
인천가정법원.인천지방법원등기국,37405,9685,12761,9448,12761,237,724
인천가정법원.인천지방법원등기국,37409,22604,21301,22322,21301,282,1416
인천가족공원입구,39493,1080,874,1062,874,18,63
인천가족공원입구,39495,1355,2276,1293,2276,62,117
인천가족공원입구,92059,2236,1583,2203,1583,33,123
인천가톨릭대학교,39931,4371,1691,4297,1691,74,195
인천경로당앞,90226,27,28,26,28,1,1
인천경로당앞,90227,12,25,12,25,0,1
인천경연초중학교,89347,39,245,37,245,2,9
인천공항T1(1층13B),35205,63,17,40,17,23,2
인천공항T1(1층2A),35344,45397,4452,44895,4452,502,1608
인천공항T1(1층2B),35202,13795,8256,13708,8256,87,711
인천공항T1(3층13번),35556,1307,10646,1197,10646,110,385
인천공항T1(3층14번),35753,836,4560,801,4560,35,174
인천공항T1(3층2번),35032,4289,37247,4257,37247,32,1339
인천공항T1(3층6번),35752,3373,9145,3333,9145,40,403
인천공항T1(3층7번),35203,14098,36462,13958,36462,140,1630
인천공항T1-3층,35325,46,0,46,0,0,1
인천공항T2(1)A(1층),35618,19821,27,19689,27,132,640
인천공항T2(1)번출입구(3층),35614,2360,19403,2344,19403,16,702
인천공항T2(6)B(1층),35619,2662,416,2640,416,22,99
인천공항T2(8)번출입구(3층),35615,254,5393,185,5393,69,182
인천공항T2-3층,35611,68,0,68,0,0,2
인천공항T2-B1층,35612,74,0,74,0,0,2
인천공항전망대,35365,5,43,5,43,0,1
인천공항전망대,35366,38,4,34,4,4,1
인천공항전망대(미정차),35630,4,0,4,0,0,0
인천공항충전소입구,35757,5,13,5,13,0,0
인천공항충전소입구,35758,36,3,36,3,0,1
인천과학예술영재학교,38579,152,71,142,71,10,7
인천과학예술영재학교,38580,38,672,33,672,5,22
인천광역시종합건설본부,37325,8262,7005,8080,7005,182,492
인천교(인천기계산업단지),37449,2203,1068,2162,1068,41,105
인천교(인천기계산업단지),37451,510,1634,474,1634,36,69
인천교삼거리,37453,3355,5563,3241,5563,114,287
인천교삼거리(인천기계산업단지),37452,2830,2120,2776,2120,54,159
인천교통공사,40032,42921,37365,42347,37365,574,2589
인천교회,38676,1635,5303,1600,5303,35,223
인천교회,39260,3713,4412,3617,4412,96,262
인천교회,39261,4140,2797,4041,2797,99,223
인천국민안전체험관,42233,2,92,0,92,2,3
인천국민안전체험관,42234,33,253,31,253,2,9
인천국제공항,35613,221,0,221,0,0,7
인천국제수산물타운,35815,20,1444,20,1444,0,47
인천국제수산물타운,35816,621,64,595,64,26,22
인천글로벌캠퍼스,39850,2292,3096,2248,3096,44,173
인천글로벌캠퍼스,39858,2824,2114,2773,2114,51,159
인천기계공고,37272,20842,7541,20601,7541,241,915
인천기계공고,37281,4638,13977,4587,13977,51,600
인천기계산업단지,37579,817,58,796,58,21,28
인천기계산업단지,37580,10,834,9,834,1,27
인천기독병원,35785,204,341,158,341,46,17
인천기독병원,35803,52,78,34,78,18,4
인천나비공원,40849,5643,205,5504,205,139,188
인천남동우체국,39630,7565,8060,7362,8060,203,504
인천남부초.힐스테이트푸르지오,37275,10536,14943,10254,14943,282,821
인천논현역앞,39658,12104,16781,11886,16781,218,931
인천논현역앞,39659,15477,9799,15283,9799,194,815
인천논현중학교,92060,170,1664,163,1664,7,59
인천논현중학교,92061,322,183,286,183,36,16
인천논현중학교,92062,1306,102,1235,102,71,45
인천대검도수련원,43456,0,113,0,113,0,3
인천대검도수련원,43695,76,1,76,1,0,2
인천대공원,39471,10808,1738,10660,1738,148,404
인천대공원,39478,8227,14801,7971,14801,256,742
인천대공원역,39395,9944,3141,9853,3141,91,422
인천대공원역,39398,91,3704,88,3704,3,122
인천대공원후문(장수동),39442,6631,1211,6483,1211,148,252
인천대입구역,38395,66715,18249,66496,18249,219,2740
인천대입구역,38396,15106,64137,14875,64137,231,2556
인천대입구역.롯데몰,38646,3223,694,3215,694,8,126
인천대입구역.롯데몰,38649,61,1682,61,1682,0,56
인천대정문,38385,32570,857,32488,857,82,1078
인천대정문,38386,1117,29709,1106,29709,11,994
인천대학교공과대학,38376,36,12368,32,12368,4,400
인천대학교공과대학,38377,45014,162,44834,162,180,1457
인천대학교공과대학,38499,1493,27806,1278,27806,215,945
인천대학교자연과학대학,38375,91,15347,74,15347,17,498
인천대학교자연과학대학,38378,21333,282,21193,282,140,697
인천마전도서관,42556,22,706,15,706,7,23
인천만수고등학교,39680,2579,2209,2563,2209,16,154
인천만수고등학교,39681,1990,2542,1978,2542,12,146
인천미래생활고등학교,40470,4614,4759,4595,4759,19,302
인천미래생활고등학교,40474,6527,5831,6453,5831,74,398
인천미래생활고등학교,40483,943,2294,927,2294,16,104
인천미래생활고등학교,55032,3416,1398,3338,1398,78,155
인천박문초등학교,38608,239,207,236,207,3,14
인천박문초등학교,38609,181,312,177,312,4,15
인천보건고등학교,42144,3545,4856,3403,4856,142,271
인천보건고등학교,42146,5718,3995,5505,3995,213,313
인천부흥고등학교,40279,1290,573,1276,573,14,60
인천북항관공선부두,89195,13,796,13,796,0,26
인천북항관공선부두,89196,627,13,624,13,3,20
인천북항부두운영시설,42953,9,305,7,305,2,10
인천북항부두운영시설,42959,375,20,363,20,12,12
인천뷰티예술고등학교,38052,3589,3801,3433,3801,156,238
인천뷰티예술고등학교,38053,7393,3996,7248,3996,145,367
인천비즈니스고등학교,37421,4592,4265,4490,4265,102,285
인천비즈니스고등학교,37423,5382,4071,5278,4071,104,304
인천비즈니스고등학교,37614,8448,3612,8311,3612,137,389
인천비지니스고등학교,37615,552,3783,547,3783,5,139
인천상공회의소,92041,58,2,58,2,0,1
인천상륙작전기념관,38671,234,191,232,191,2,13
인천상륙작전기념관,38672,72,255,69,255,3,10
인천서곶초등학교,89355,490,4,483,4,7,15
인천서곶초등학교,89358,9,962,5,962,4,31
인천서부교육지원청,42336,529,332,525,332,4,27
인천서부교육지원청,42337,242,1231,238,1231,4,47
인천서부여성회관,42131,1863,1445,1800,1445,63,106
인천서부여성회관,42134,4162,4931,4024,4931,138,293
인천서창동우체국,39820,4746,9457,4688,9457,58,458
인천서창동우체국,39821,10042,2356,9947,2356,95,399
인천서창중학교,39767,5523,3794,5414,3794,109,300
인천서창중학교,39875,4813,2782,4693,2782,120,245
인천성모병원정문,40844,9049,10662,8885,10662,164,635
인천성모병원정문,40857,9570,7435,9447,7435,123,548
인천성모병원종점지주차장,40919,200,2349,179,2349,21,82
인천성모병원후문,40138,1951,7524,1870,7524,81,305
인천성모병원후문,40139,4476,1968,4374,1968,102,207
인천세무서,36169,4,34,4,34,0,1
인천세무서후문,36179,66,134,66,134,0,6
인천소방본부,37189,3742,7878,3591,7878,151,374
인천소방본부,37191,8783,4415,8513,4415,270,425
인천소방항공대,35809,116,12,110,12,6,4
인천소방항공대,35810,10,196,6,196,4,6
인천송도꿈유치원,38622,7429,10,7413,10,16,239
인천송도꿈유치원,38623,173,8440,140,8440,33,277
인천송일초등학교,38558,545,1322,501,1322,44,60
인천송일초등학교,38575,1205,1103,1158,1103,47,74
인천수산물센터,35069,6935,7701,6518,7701,417,472
인천스타트업파크,38390,1816,740,1796,740,20,82
인천스타트업파크,38394,905,2770,874,2770,31,118
인천시교육청 교육연수원,35782,0,1,0,1,0,0
인천시청후문,39290,13886,9871,13815,9871,71,766
인천시청후문,39292,12366,13095,12148,13095,218,821
인천아시아드주경기장(동문),89354,1229,26,998,26,231,40
인천아시아드주경기장(동문),89359,144,1254,122,1254,22,45
인천아시아드테니스장,89356,757,41,690,41,67,25
인천아시아드테니스장,89357,45,945,29,945,16,31
인천여객터미널,89155,0,328,0,328,0,10
인천여자고등학교,38287,9007,9025,8831,9025,176,581
인천여자고등학교,38289,5109,5826,4852,5826,257,352
인천여자상업고등학교,35139,463,2558,457,2558,6,97
인천여자상업고등학교·이마트,35141,9403,3085,9231,3085,172,402
인천역(차이나타운),35178,43639,25901,42806,25901,833,2243
인천역(차이나타운),35179,29638,42724,29235,42724,403,2334
인천연세병원,42310,2939,2915,2853,2915,86,188
인천연합의원,42601,2811,4181,2757,4181,54,225
인천영어마을,42454,5411,3227,5345,3227,66,278
인천영어마을,42697,4275,10162,4196,10162,79,465
인천예림학교(인천성모병원),40819,6401,6291,6299,6291,102,409
인천예림학교(인천성모병원),40820,7115,4699,7004,4699,111,381
인천예술고등학교,39332,981,553,970,553,11,49
인천예술고등학교,39533,592,794,572,794,20,44
인천옹진농협본점,35555,6845,4847,6516,4847,329,377
인천옹진농협본점,35797,841,1599,802,1599,39,78
인천의료원,36093,609,4740,598,4740,11,172
인천의료원,36107,16400,9025,16221,9025,179,820
인천의료원,36108,9272,12898,9194,12898,78,715
인천의료원,37458,5431,763,5368,763,63,199
인천이음중학교,89456,2,18,2,18,0,0
인천이음초등학교,89399,3560,405,3498,405,62,127
인천이음초등학교,89400,1630,8046,1604,8046,26,312
인천인력개발원,39071,1408,707,1399,707,9,68
인천인력개발원,39072,613,1794,595,1794,18,77
인천재능대정문,36172,6,4,6,4,0,0
인천재능대정문,36175,1,4,1,4,0,0
인천재능대후문,36173,0,5,0,5,0,0
인천재능대후문,36174,12,8,12,8,0,0
인천적십자병원(풍림아파트),38240,4129,5034,4003,5034,126,295
인천적십자병원(풍림아파트),38339,6548,4899,6388,4899,160,369
인천정보과학고등학교,35175,3424,4450,3274,4450,150,254
인천정보과학고등학교,35183,6614,1803,6334,1803,280,271
인천정보과학고등학교,35800,15,11,12,11,3,0
인천정보과학고등학교,36002,2705,5832,2608,5832,97,275
인천종합수산물센터,35074,5293,264,5083,264,210,179
인천준법지원센터·미추홀트루엘파크,37147,761,207,744,207,17,31
인천준법지원센터·미추홀트루엘파크,37148,74,774,73,774,1,27
인천지방법원,37096,4513,73,4392,73,121,147
인천지방중소기업청입구,39087,3009,1135,2998,1135,11,133
인천체육고등학교,89233,234,347,217,347,17,18
인천체육고등학교입구,89048,41,28,41,28,0,2
인천체육고등학교입구,89049,0,65,0,65,0,2
인천축구전용경기장,36184,61,22,44,22,17,2
인천축구전용경기장,37286,1937,2506,1828,2506,109,143
인천축구전용경기장,37303,3063,1531,2999,1531,64,148
인천축구전용경기장(서희스타힐스),37558,122,1475,119,1475,3,51
인천축산농협,40454,411,846,404,846,7,40
인천축산농협,40457,474,1041,454,1041,20,48
인천축산물시장,42010,1326,847,1288,847,38,70
인천축산물시장,42011,800,1222,794,1222,6,65
인천출입국·외국인청,35127,13172,1587,13014,1587,158,476
인천출입국·외국인청,35129,1037,10396,961,10396,76,368
인천터미널,37215,2100,33,2086,33,14,68
인천터미널사거리입구,39194,1284,5210,1265,5210,19,209
인천터미널역,37648,569,47,568,47,1,19
인천테크노밸리U1센터,40605,4138,5960,4029,5960,109,325
인천테크노밸리U1센터,40607,7401,4683,7255,4683,146,389
인천푸른빛유치원,89376,1002,81,987,81,15,34
인천푸른빛유치원,89377,115,1062,104,1062,11,37
인천항신국제여객터미널,38652,870,508,859,508,11,44
인천항신국제여객터미널(하행),38662,395,820,340,820,55,39
인천해든초등학교,89410,1939,1016,1939,1016,0,95
인천해든초등학교,89411,1316,2483,1302,2483,14,122
인천해양과학고,38120,2259,1297,2173,1297,86,114
인천해양과학고,38566,656,301,628,301,28,30
인천향교.인천도호부청사,37124,5822,12402,5656,12402,166,587
인천향교.인천도호부청사,37125,9281,2230,9024,2230,257,371
인천향교유림회관,37059,14425,4434,14109,4434,316,608
인천향교유림회관,37062,8454,13986,8254,13986,200,723
인천환경공단입구,42930,533,124,519,124,14,21
인천힘찬종합병원,39628,5859,4111,5765,4111,94,321
인천힘찬종합병원,39629,4031,4106,3885,4106,146,262
인평자동차고,40149,13219,16465,13009,16465,210,957
인평자동차고,40151,1283,634,1233,634,50,61
인평자동차고,40152,356,1031,351,1031,5,44
인평자동차고,40787,17651,9207,17357,9207,294,866
인하대병원,35119,13428,9650,13093,9650,335,744
인하대병원,35121,4057,1578,3939,1578,118,181
인하대병원,35486,5329,5504,5146,5504,183,349
인하대병원입구,35846,6501,11986,6263,11986,238,596
인하대역,37596,19,8131,19,8131,0,262
인하대역(1번출구),37066,74702,73369,73653,73369,1049,4776
인하대역(7번출구),37091,101435,73112,100106,73112,1329,5630
인하대역3번출구,37127,3757,19821,3674,19821,83,760
인하대역4번출구,37122,13655,5072,13419,5072,236,604
인하대정문,37099,21149,8526,20929,8526,220,957
인하대정문,37104,8605,21937,8393,21937,212,985
인하대후문,37165,71390,4357,71227,4357,163,2443
인하대후문,37166,1555,1341,1548,1341,7,93
인하대후문,37167,11105,69303,10910,69303,195,2593
인향아파트,40557,8078,560,7945,560,133,278
인향아파트,40559,454,6762,442,6762,12,232
인향아파트,41464,2681,129,2632,129,49,90
인향아파트,41465,82,6493,54,6493,28,212
인혜학교후문(원욱그린타운),41473,1669,592,1655,592,14,72
인혜학교후문(원욱그린타운),41518,657,3411,639,3411,18,131
인화1리마을회관,90210,3,5,3,5,0,0
인화1리마을회관,90211,10,6,10,6,0,0
인화리종점,43473,65,36,58,36,7,3
인화성입구,90063,1,11,1,11,0,0
인화성입구,90064,44,3,39,3,5,1
인화여고,37547,4493,4365,4243,4365,250,285
인화여고,37548,7786,13663,7624,13663,162,691
일신동행정복지센터,40200,7594,3551,7435,3551,159,359
일신동행정복지센터,40205,148,2653,138,2653,10,90
일신동행정복지센터,40220,3134,2776,3104,2776,30,190
일신시장,40207,4787,5920,4725,5920,62,345
일신시장,40210,6042,2730,5852,2730,190,282
일신주공,40866,414,1127,409,1127,5,49
일신주공109동,40868,6299,3967,6194,3967,105,331
임광그대가.서창자이아파트,39514,3891,1432,3868,1432,23,171
임광그대가.서창자이아파트,39515,304,4148,303,4148,1,143
임광그대가103동,92025,3292,3162,3221,3162,71,208
임송촌,43423,9,11,9,11,0,0
임송촌,43802,88,103,86,103,2,6
임학사거리,41283,508,1896,497,1896,11,77
임학역,41290,17487,24292,17264,24292,223,1347
임학역,41292,24511,14625,24131,14625,380,1262
임학지하차도앞사거리,41287,26,3943,26,3943,0,128
임학지하차도앞사거리,41288,3088,14,3088,14,0,100
입구지,35300,53,4,50,4,3,1
입구지,35751,2,32,2,32,0,1
입구지입구,35477,17,83,16,83,1,3
입구지입구,35478,70,3,70,3,0,2
자동차매매단지,11020,199,658,185,658,14,27
자동차매매단지,11021,580,204,580,204,0,25
자동차매매단지,36094,254,4688,246,4688,8,159
자동차매매단지,37459,3601,317,3581,317,20,126
자연사박물관,43451,2,0,2,0,0,0
자연사박물관,43667,0,1,0,1,0,0
자이금호힐스테이트,42849,353,4180,345,4180,8,146
자이금호힐스테이트,42850,2812,315,2697,315,115,100
자이더테라스1단지,89297,1349,431,1335,431,14,57
자이더테라스1단지,89298,567,1343,559,1343,8,61
자이더테라스2단지,42864,1531,2619,1502,2619,29,133
자이더테라스2단지,42871,2660,1099,2555,1099,105,121
작은구월사거리,39239,6023,6310,5936,6310,87,397
작은구월사거리,39240,7274,6745,7142,6745,132,452
작전1동주민센터,41113,15460,8820,15240,8820,220,783
작전동삼성홈플러스,41044,16852,31968,16652,31968,200,1574
작전동삼성홈플러스,41050,20627,9540,20339,9540,288,973
작전동풍림아파트,41090,261,1100,252,1100,9,43
작전서운동행정복지센터,41103,470,2795,444,2795,26,105
작전서운동행정복지센터,41104,2751,572,2671,572,80,107
작전역,41561,7971,5322,7932,5322,39,428
작전역,41562,5686,8108,5649,8108,37,444
작전역 서해그랑블,41047,2728,2591,2599,2591,129,171
작전역 서해그랑블,41414,1401,3416,1384,3416,17,155
작전역1번출구,41095,12232,16755,12048,16755,184,935
작전역2번출구,41092,5116,6865,5058,6865,58,386
작전역3번출구,41076,9239,4369,9181,4369,58,438
작전역4번출구,41062,16391,33611,16192,33611,199,1612
작전역5번출구,41057,61352,35762,60833,35762,519,3132
작전역6번출구,41433,3788,28880,3765,28880,23,1053
작전역7번출구,41401,26486,6688,26317,6688,169,1070
작전역8번출구,41093,11041,11205,10927,11205,114,717
작전중고.여고앞,41116,3941,3327,3844,3327,97,234
작전초등학교,41127,3450,2867,3375,2867,75,203
작전초등학교,41128,3163,2407,3093,2407,70,179
작전풍림아파트,41080,768,6527,718,6527,50,235
작전풍림아파트,41091,8393,3242,8266,3242,127,375
잔다리삼거리,35519,28,23,26,23,2,1
잔다리삼거리,35559,38,43,38,43,0,2
잔다리삼거리,35856,3,8,3,8,0,0
잔다리삼거리,35857,8,0,8,0,0,0
잔다리새마을,35866,20,38,9,38,11,1
잔다리새마을,35867,13,89,13,89,0,3
잔솔밭,43943,25,25,24,25,1,1
잔솔밭,43944,1,7,1,7,0,0
잠진도삼거리,35743,39,7,38,7,1,1
잠진도삼거리,35744,8,140,8,140,0,4
잠진도입구,35749,52,54,52,54,0,3
잠진도입구,35750,29,90,29,90,0,3
장경리공영주차장,44141,6,20,6,20,0,0
장경리공영주차장,44190,38,6,31,6,7,1
장경리해수욕장,44092,30,62,27,62,3,2
장경리해수욕장,44191,51,15,47,15,4,2
장곡.고촌고등학교,80066,180,91,179,91,1,8
장곡.고촌고등학교,80288,16,66,16,66,0,2
장곶돈대,43931,54,72,49,72,5,4
장곶돈대,43932,23,45,21,45,2,2
장곶횟집,43118,10,23,10,23,0,1
장곶횟집,43478,11,44,11,44,0,1
장구란,90349,4,13,0,13,4,0
장구란,90354,2,12,2,12,0,0
장기동,41345,1092,52,1088,52,4,36
장기동,41346,77,3484,75,3484,2,114
장기동,41347,2344,17497,2314,17497,30,640
장기동,41348,22220,3000,21994,3000,226,813
장도초등학교,39127,485,591,467,591,18,34
장도초등학교,39129,2167,1008,2131,1008,36,102
장릉입구,80046,9,154,9,154,0,5
장릉입구,80047,263,1,259,1,4,8
장미아파트,37044,6425,9057,6210,9057,215,499
장미아파트,37092,23021,11009,22680,11009,341,1097
장미아파트,37094,10777,17614,10587,17614,190,915
장미아파트(19동)앞,37474,2957,2852,2902,2852,55,187
장미아파트(19동)앞,37540,2429,4050,2305,4050,124,209
장서초등학교,39965,2552,560,2517,560,35,100
장서초등학교,39966,1088,7493,1067,7493,21,276
장수.서창동행정복지센터,39580,4502,9503,4435,9503,67,451
장수.서창동행정복지센터,39581,9245,1848,9185,1848,60,357
장수공영차고지,39566,1050,288,636,288,414,43
장수공영차고지,92064,655,268,15,268,640,29
장수교,39336,602,575,596,575,6,37
장수교(서창동입구),39337,324,1316,315,1316,9,52
장수동,39373,845,2148,827,2148,18,96
장수동,39391,1355,1465,1322,1465,33,90
장수동,39393,5270,5700,5157,5700,113,353
장수빌라,39577,422,1359,411,1359,11,57
장수사거리,39389,14222,4390,14028,4390,194,600
장수사거리,39397,145,2702,140,2702,5,91
장수사거리,39501,3247,7979,3149,7979,98,362
장수사거리,39542,5741,432,5598,432,143,199
장수주공(청소년수련원),39417,36,2045,34,2045,2,67
장수주공(청소년수련원),39424,3089,72,3028,72,61,101
장수초등학교,39342,3797,1878,3668,1878,129,183
장수초등학교,39352,1124,2888,1102,2888,22,129
장수파출소,39543,15,680,15,680,0,22
장승마루,90028,1,13,1,13,0,0
장승마루,90029,14,0,14,0,0,0
장승마을,43200,0,34,0,34,0,1
장승마을,43714,90,0,70,0,20,2
장승백이시장,39280,3960,1469,3902,1469,58,175
장승백이시장,39282,667,4215,659,4215,8,157
장아초등학교,39873,1082,630,1063,630,19,55
장아초등학교,39874,122,1785,107,1785,15,61
장안,43418,22,40,22,40,0,2
장안,43445,57,24,52,24,5,2
장안마을,43133,8,0,8,0,0,0
장안마을,43855,1,2,1,2,0,0
장안말(구초지분교)입구,90083,55,133,53,133,2,6
장안말(구초지분교)입구,90084,175,69,165,69,10,7
장안말(온천스파),43144,13,5,13,5,0,0
장안말(온천스파),43253,52,2,48,2,4,1
장안말(온천스파),43892,6,3,6,3,0,0
장안사거리,37285,16637,3293,16390,3293,247,642
장안사거리,37295,4746,18077,4615,18077,131,736
장안촌동쪽,43933,5,33,5,33,0,1
장암마을,90155,114,90,108,90,6,6
장암마을,90156,60,66,56,66,4,4
장애인복지관,37249,2531,2961,2489,2961,42,177
장애인종합복지관,43627,1,10,1,10,0,0
장인가구,39706,202,307,196,307,6,16
장자말,43142,0,8,0,8,0,0
장자말,43257,46,0,40,0,6,1
장자촌,43141,22,0,20,0,2,0
장자촌,43255,0,1,0,1,0,0
장전,43415,48,5,48,5,0,1
장전,43500,3,21,3,21,0,0
장정2리마을회관,43665,0,74,0,74,0,2
장정2리마을회관,43693,184,1,174,1,10,5
장지포,90238,1,14,1,14,0,0
장지포,90239,1,4,1,4,0,0
장천사거리,37282,1750,1934,1717,1934,33,118
장천사거리,37610,272,1073,260,1073,12,43
장천사거리,37651,286,1175,282,1175,4,47
장촌길 입구,90379,12,3,12,3,0,0
장촌길 입구,90382,11,4,11,4,0,0
장촌마을,35475,104,13,101,13,3,3
장촌마을,35476,14,126,8,126,6,4
장촌빌라,35321,160,45,153,45,7,6
장촌빌라,35397,23,137,19,137,4,5
장하,43184,5,34,5,34,0,1
장하,43204,62,5,59,5,3,2
장화교회앞,43121,27,38,18,38,9,2
장화교회앞,43539,57,19,47,19,10,2
장화리학생수련원,43426,43,83,42,83,1,4
장화리학생수련원,43474,9,17,9,17,0,0
장흥낚시터,43211,0,1,0,1,0,0
장흥낚시터,43890,3,1,3,1,0,0
장흥리종점,43643,22,21,19,21,3,1
장흥리종점,43888,18,10,12,10,6,0
장흥매점,43641,1,1,1,1,0,0
장흥매점,43891,0,2,0,2,0,0
장흥삼거리,43153,15,7,15,7,0,0
장흥삼거리,43881,11,43,11,43,0,1
장흥저수지(성공회.해든뮤지움),90081,196,129,187,129,9,10
장흥저수지(성공회.해든뮤지움),90082,91,224,83,224,8,10
재능대학교서문,36058,20738,26553,20295,26553,443,1525
재능대학교서문,36119,17728,16571,17491,16571,237,1106
재활용품수집장,43165,1,14,1,14,0,0
저수지관리소,43264,52,2,51,2,1,1
저수지휴게소,43567,15,55,15,55,0,2
적두마을(월곳교회),43190,27,0,26,0,1,0
적두마을(월곳교회),43709,0,38,0,38,0,1
적석사입구,43348,10,62,10,62,0,2
적석사입구,43847,100,4,90,4,10,3
전동교회,35199,7938,5816,7517,5816,421,443
전동교회,35200,2954,9091,2875,9091,79,388
전득이고개입구,90187,14,9,13,9,1,0
전득이고개입구,90188,23,92,21,92,2,3
전들,43477,78,0,78,0,0,2
전들,43835,5,78,1,78,4,2
전등사남문,43515,179,417,141,417,38,19
전등사남문,43893,360,103,349,103,11,14
전등사동문,43521,184,801,171,801,13,31
전등사동문,43895,570,374,548,374,22,30
전소,35231,6365,5060,6115,5060,250,368
전소,35232,6665,5693,6446,5693,219,398
전원미술관앞,43387,224,12,217,12,7,7
전원미술관앞,43810,9,258,9,258,0,8
전인연립(종점),40132,100,253,96,253,4,11
점촌,43414,95,1,67,1,28,3
점촌,43806,0,54,0,54,0,1
젓개마을,35828,8,46,6,46,2,1
젓개마을,35829,2,8,2,8,0,0
젓개마을입구,35322,9,8,9,8,0,0
정광아파트(병무청),37008,4472,48,4429,48,43,145
정광아파트(병무청),37009,12,4847,5,4847,7,156
정광아파트.만수주공11단지,39476,7658,7337,7589,7337,69,483
정광아파트.만수주공11단지,39477,7590,4927,7501,4927,89,403
정기무역,35083,2541,228,2426,228,115,89
정다운그린빌,92024,1463,3201,1440,3201,23,150
정든마을아파트,40055,849,1168,841,1168,8,65
정든마을아파트,40057,795,789,786,789,9,51
정병원,40413,4891,4430,4827,4430,64,300
정부인천지방합동청사,37386,37178,18016,36725,18016,453,1780
정부인천지방합동청사,37388,26142,32639,25693,32639,449,1896
정비단지,37005,2159,1577,2103,1577,56,120
정비단지,37006,835,2349,788,2349,47,102
정서진삼거리,89234,2,345,2,345,0,11
정석항공과학고,37168,29887,5192,29663,5192,224,1131
정석항공과학고,37170,9007,33973,8923,33973,84,1386
정수사입구,43404,88,11,87,11,1,3
정수사입구,43436,44,53,41,53,3,3
정왕IC(미정차),92007,3,0,3,0,0,0
정하,43183,60,21,55,21,5,2
정하,43208,1,40,1,40,0,1
제물포시장,37310,720,734,700,734,20,46
제물포시장,37311,866,807,857,807,9,53
제물포여자중학교,37288,4322,2805,4238,2805,84,229
제물포여자중학교,37290,6826,5359,6721,5359,105,393
제물포여자중학교,37298,10964,12821,10669,12821,295,767
제물포역,37355,58300,38015,57451,38015,849,3106
제물포역,37364,37341,26316,36766,26316,575,2053
제물포역,37496,37156,44019,36139,44019,1017,2618
제물포역,37498,19242,7114,19020,7114,222,850
제물포역,37502,36063,47824,35517,47824,546,2706
제물포역(동양빌딩),37339,452,4815,444,4815,8,169
제물포중학교,42064,2328,2950,2248,2950,80,170
제물포중학교,42065,2956,1603,2922,1603,34,147
제운사거리(청년창업특화거리),37175,2870,4329,2740,4329,130,232
제운사거리(청년창업특화거리),37534,2435,5029,2385,5029,50,240
제일시장,37316,8038,7121,7959,7121,79,489
제일시장,37329,11734,11487,11550,11487,184,749
제일시장사거리,37667,1223,592,1159,592,64,58
제일주유소,57020,2504,1839,2480,1839,24,140
제일주유소,57021,1256,3781,1236,3781,20,162
제일풍경채,42833,2887,3066,2867,3066,20,192
제일풍경채1차정문앞,89350,2321,1342,2310,1342,11,118
제일풍경채2차,89349,29,478,29,478,0,16
제일풍경채2차321동앞,42866,2973,1062,2867,1062,106,130
제일풍경채2차321동앞,42873,361,1292,334,1292,27,53
제일풍경채2차323동앞,42891,5366,6574,5252,6574,114,385
제일풍경채2차331동앞,42989,1589,4196,1528,4196,61,186
제적봉앞마을,90060,0,6,0,6,0,0
제적봉앞마을,90061,0,0,0,0,0,0
제적봉입구,43654,4,37,4,37,0,1
제적봉입구,43686,8,2,8,2,0,0
조광교회입구,43533,6,0,5,0,1,0
조광교회입구,43868,0,31,0,31,0,1
조달청(한양2차아파트),37511,6322,14858,6070,14858,252,683
조달청비축기지,35114,1925,5358,1871,5358,54,234
조달청비축기지,35115,4652,2066,4578,2066,74,216
조동초등학교,39464,3302,1717,3257,1717,45,161
조동초등학교,39465,15,1202,13,1202,2,39
조리미입구,80068,1695,33,1689,33,6,55
조리미입구,80069,52,1608,52,1608,0,53
조바위,90350,5,43,5,43,0,1
조바위,90351,14,1,13,1,1,0
조산,43192,17,83,13,83,4,3
조산,43334,114,30,109,30,5,4
조산교회,43172,8,39,8,39,0,1
조산교회,43338,62,5,49,5,13,2
조산초등학교,43189,101,267,101,267,0,11
조산초등학교,43593,158,13,150,13,8,5
종갱이,43180,58,144,56,144,2,6
종갱이,43288,161,97,155,97,6,8
종근당,40002,429,8,418,8,11,14
종근당,40005,11,902,11,902,0,29
종근당.충정로역,11002,119,9041,118,9041,1,295
종로약국,57005,726,1002,702,1002,24,55
종로약국,57007,1860,910,1821,910,39,89
종생마을,80161,854,118,815,118,39,31
종생마을,80162,116,1343,110,1343,6,47
종점(병무청),37014,3093,53,2972,53,121,101
종합터미널,37242,51502,23870,50865,23870,637,2431
종합터미널,39177,13946,45155,13695,45155,251,1906
종현동정보화마을,62043,29,154,29,154,0,5
종현동정보화마을,62044,172,35,169,35,3,6
좌동교차로,89371,9,75,7,75,2,2
좌동마을,42452,172,49,163,49,9,7
좌동마을,89253,52,195,50,195,2,7
좌동마을입구,42456,37,130,37,130,0,5
좌동마을입구,42928,232,58,232,58,0,9
주거단지,35118,346,338,323,338,23,22
주거단지,35120,181,768,173,768,8,30
주공12단지,35082,812,181,812,181,0,32
주공12단지,35084,520,334,506,334,14,27
주공6단지후문,40453,5212,2748,5182,2748,30,256
주공뜨란채아파트,40708,4604,3673,4528,3673,76,267
주공뜨란채아파트,40803,3809,3775,3790,3775,19,244
주공아파트,40867,410,736,405,736,5,36
주물단지,42291,976,3942,975,3942,1,158
주안1동행정복지센터,37385,6129,7715,6020,7715,109,446
주안2동치안센터,37302,8411,5034,8276,5034,135,433
주안4동행정복지센터,37333,267,195,264,195,3,14
주안4동행정복지센터,37335,101,567,99,567,2,21
주안5동행정복지센터,37526,757,1017,721,1017,36,57
주안7동행정복지센터,37214,21070,20625,20701,20625,369,1345
주안7동행정복지센터,37216,22855,17234,22365,17234,490,1293
주안국가산단역,37583,6816,615,6795,615,21,239
주안국가산단역,37584,30,2210,26,2210,4,72
주안남초등학교,37283,8039,7359,7818,7359,221,496
주안남초등학교,37284,13335,5191,13152,5191,183,597
주안도서관,37341,111,130,110,130,1,7
주안도서관,37342,107,160,102,160,5,8
주안매매단지,37586,347,661,336,661,11,32
주안북부역,37418,21081,15924,20892,15924,189,1193
주안북부역,37420,18814,14037,18676,14037,138,1059
주안북초등학교,37417,4587,7255,4555,7255,32,382
주안사거리,37330,18490,13031,17961,13031,529,1016
주안사거리,37514,3494,8855,3472,8855,22,398
주안시범공단,39927,361,535,360,535,1,28
주안아파트,37207,880,2215,853,2215,27,99
주안아파트,37209,1389,1517,1351,1517,38,93
주안역,37387,86734,30454,85456,30454,1278,3780
주안역,37389,21396,86231,21082,86231,314,3471
주안역,37402,867,4112,855,4112,12,160
주안역,37506,25407,17687,25023,17687,384,1390
주안역센트레빌아파트,37430,8203,15730,8101,15730,102,772
주안역센트레빌아파트정문,37490,1152,1037,1147,1037,5,70
주안역환승정류장,37503,98200,67319,97274,67319,926,5339
주안역환승정류장,37617,161364,135696,160707,135696,657,9582
주안파크자이더플래티넘아파트,37201,15083,8679,14837,8679,246,766
주안파크자이더플래티넘아파트,37204,9017,15620,8695,15620,322,794
주안현대아파트,37358,20098,16989,19470,16989,628,1196
주원고개,39377,1466,3884,1365,3884,101,172
주원고개,39396,4124,10342,4010,10342,114,466
주적골,39510,746,2229,713,2229,33,95
주적골,39608,926,1094,912,1094,14,65
주택마을,90230,15,69,9,69,6,2
중고등학교,44106,7,32,5,32,2,1
중고등학교,44193,72,67,50,67,22,4
중고차매매단지엠파크허브,42038,513,692,501,692,12,38
중곡고개,43935,2,0,0,0,2,0
중구노인복지회관,35151,12175,10533,11881,10533,294,732
중구노인복지회관,35152,13284,12429,12947,12429,337,829
중구문화회관,35466,1,552,1,552,0,17
중구문화회관,35467,1604,156,1576,156,28,56
중구청,35157,2651,1564,2606,1564,45,135
중구청,35159,929,3610,889,3610,40,146
중구청소년수련관.하늘중학교,35824,2848,624,2719,624,129,112
중독고개,43936,38,32,27,32,11,2
중박골입구,44123,37,11,36,11,1,1
중박골입구,44194,13,0,10,0,3,0
중봉로교차로,89420,645,896,635,896,10,49
중봉로교차로,89421,213,237,209,237,4,14
중부고용노동청(인천고용센터),39222,697,868,694,868,3,50
중부고용노동청(인천고용센터),39223,743,587,733,587,10,42
중산고등학교,35868,95,477,83,477,12,18
중산고등학교,35869,404,317,386,317,18,23
중산교차로,35652,955,370,932,370,23,42
중산교차로,35653,343,3042,331,3042,12,109
중산동,35305,2053,565,1990,565,63,84
중산동(까치빌라앞),35247,557,892,536,892,21,46
중산동(중촌),35272,517,1426,495,1426,22,62
중산동(중촌),35278,32,269,12,269,20,9
중산중고등학교,35817,243,250,235,250,8,15
중산중고등학교,35818,107,392,102,392,5,16
중산중학교,35656,1750,936,1574,936,176,86
중산중학교,35657,878,1477,816,1477,62,75
중앙공영아파트,41268,4359,1120,4225,1120,134,176
중앙공원사거리,39189,777,1260,767,1260,10,65
중앙방앗간,35852,0,4,0,4,0,0
중앙방앗간,35853,0,1,0,1,0,0
중앙사료,42014,2114,1420,2065,1420,49,114
중앙사료,42015,444,972,437,972,7,45
중앙산부인과,70176,7,247,7,247,0,8
중앙산부인과,70230,439,56,421,56,18,15
중앙시장,90125,2028,530,1883,530,145,82
중앙시장.고려궁지입구,43067,870,1809,847,1809,23,86
중앙아파트,40409,638,594,628,594,10,39
중앙아파트,42315,3054,2463,2986,2463,68,177
중앙하이츠,41110,4040,11986,3931,11986,109,516
중앙호수공원입구(호반베르디움),89245,31,707,13,707,18,23
중원고등학교,55078,1918,586,1910,586,8,80
중촌,43252,149,0,135,0,14,4
중촌,43369,1,76,1,76,0,2
중촌교차로,35436,129,679,114,679,15,26
중촌교차로,35443,1174,268,1137,268,37,46
중혈마을,43176,13,46,13,46,0,1
중혈마을,43299,84,6,83,6,1,2
중흥S클래스,42832,2111,1654,2074,1654,37,121
중흥S클래스,42847,784,563,769,563,15,43
중흥S클래스1차,42844,390,916,374,916,16,42
중흥S클래스1차,42845,676,653,668,653,8,42
중흥S클래스2차,42771,5601,1301,5388,1301,213,222
중흥S클래스2차,42856,4945,862,4705,862,240,187
중흥마을.은하마을,55070,872,377,872,377,0,40
지랏돌,90071,184,25,177,25,7,6
지랏돌,90072,1,23,1,23,0,0
지산리입구,43310,7,1,7,1,0,0
지산리입구,43751,3,3,3,3,0,0
지산입구(용진),43538,23,3,22,3,1,0
지산입구(용진),43679,4,34,4,34,0,1
지산주택,38202,25,1295,17,1295,8,42
지석리마을회관,90274,5,5,5,5,0,0
지석리망향단입구,90273,1,6,1,6,0,0
지석리오현부락,90275,10,13,10,13,0,0
지석초등학교입구,90277,28,10,28,10,0,1
지식정보단지역,38373,7657,1000,7637,1000,20,279
지식정보단지역,38403,9372,1075,9336,1075,36,337
지식정보단지역,38404,258,7162,252,7162,6,239
지식정보단지역(4번출구),38380,531,10044,525,10044,6,341
진고개(5연대입구),43380,198,86,195,86,3,9
진고개(5연대입구),43794,33,204,33,204,0,7
진광횟집앞,43507,18,9,16,9,2,0
진광횟집앞,43541,13,17,13,17,0,0
진달래아파트,37600,17,844,7,844,10,27
진도로르빌아파트,37471,1618,3516,1587,3516,31,165
진두방앗간,44129,0,21,0,21,0,0
진두방앗간,44195,8,3,8,3,0,0
진산과학고등학교,40640,113,353,0,353,113,15
진산과학고등학교,40915,89,4,74,4,15,3
진산중학교,40575,1271,3293,1213,3293,58,147
진산초등학교,40614,1026,3633,1008,3633,18,150
진산초등학교,40633,205,186,2,186,203,12
진산초등학교,40914,392,66,280,66,112,14
진주5단지503동앞,42089,3987,3582,3931,3582,56,244
진주상가,42544,4100,226,4048,226,52,139
진주아파트2단지,42092,375,12096,367,12096,8,402
진주아파트2단지6동,42084,129,7325,128,7325,1,240
진주아파트3단지,42086,8722,146,8640,146,82,286
진주아파트4단지,42077,3886,139,3856,139,30,129
진표에너지,42548,3,421,0,421,3,13
진흥아파트,37190,3288,2628,3239,2628,49,190
진흥아파트,37193,2750,3819,2713,3819,37,211
진흥아파트,37240,7315,4174,7175,4174,140,370
진흥아파트,37243,6301,11517,6201,11517,100,574
진흥아파트,39297,8311,8194,8234,8194,77,532
집단에너지,39064,66,113,65,113,1,5
집단에너지시설,39065,94,122,93,122,1,6
짓절미,43485,38,34,32,34,6,2
짓절미,43713,11,12,10,12,1,0
찬우물,39179,1245,3817,1226,3817,19,163
찬우물,39188,2168,929,2115,929,53,99
찬우물,43048,163,310,154,310,9,15
찬우물약수터,43851,155,333,141,333,14,15
참빛감리교회,42437,18063,11394,17550,11394,513,950
참좋은집,36160,325,11,321,11,4,10
참좋은집,36161,11,409,4,409,7,13
창골,43549,219,105,214,105,5,10
창리,43052,251,309,238,309,13,18
창리,43053,288,312,264,312,24,19
창리,43054,284,357,267,357,17,20
창리,43902,98,58,82,58,16,5
창리,43903,5,0,5,0,0,0
창신초등학교,42620,3021,1222,2965,1222,56,136
창신초등학교,42621,1695,1908,1667,1908,28,116
창영어린이공원,36168,3,32,3,32,0,1
창후1리마을회관,43595,152,0,140,0,12,4
창후1리마을회관,43783,1,169,1,169,0,5
창후리입구,43604,153,15,138,15,15,5
창후리입구,43830,33,188,32,188,1,7
창후리종점,43774,49,78,46,78,3,4
창후정미소,43461,80,1,71,1,9,2
창후정미소,43600,5,44,4,44,1,1
채석장,38179,1233,443,1184,443,49,54
천곡,43409,188,0,176,0,12,6
천곡,43827,21,176,21,176,0,6
천촌,43411,2,110,1,110,1,3
천촌,43795,158,3,140,3,18,5
철곶,43653,5,14,1,14,4,0
철곶,43759,18,4,14,4,4,0
철산리검문소,43957,6,29,5,29,1,1
철산리검문소,43958,34,4,34,4,0,1
철산리입구,43685,35,25,35,25,0,1
철산리입구,43741,5,36,5,36,0,1
첨단초등학교,92014,299,3601,290,3601,9,125
청광플러스원102동앞,39946,2106,202,2106,202,0,74
청광플러스원아파트,39775,6802,2508,6702,2508,100,300
청광플러스원아파트,39786,1741,8181,1678,8181,63,320
청능로사거리,39622,45641,17019,44682,17019,959,2021
청능로사거리,39623,18843,43596,18231,43596,612,2014
청라1동행정복지센터,42744,14732,5658,14496,5658,236,657
청라1동행정복지센터,42745,7581,11847,7387,11847,194,626
청라2동행정복지센터,89039,3026,482,2997,482,29,113
청라2동행정복지센터,89042,1093,3038,1029,3038,64,133
청라3동행정복지센터,89374,1212,3639,1185,3639,27,156
청라3동행정복지센터,89375,4524,823,4515,823,9,172
청라BRT차고지입구,89336,122,276,1,276,121,12
청라BRT차고지입구,89337,639,53,500,53,139,22
청라고등학교,42784,2265,1127,2220,1127,45,109
청라고등학교,42785,1092,2316,1023,2316,69,109
청라골프아카데미,89255,130,40,130,40,0,5
청라골프아카데미,89256,84,116,77,116,7,6
청라국제도서관,42922,70,312,63,312,7,12
청라국제도서관,42923,384,73,371,73,13,14
청라국제도시역,89270,38005,469,37871,469,134,1241
청라국제도시역(경명대로),89034,8455,11137,8409,11137,46,632
청라국제도시역(서부산단방향),89043,25824,29180,25552,29180,272,1774
청라국제도시역(청라국제교방향),89215,29986,22238,29705,22238,281,1684
청라국제어린이집,89289,302,32,291,32,11,10
청라국제업무단지(골드클래스),42984,704,535,692,535,12,39
청라꽃농원,42991,151,103,151,103,0,8
청라달튼국제학교,42895,1287,1303,1155,1303,132,83
청라달튼국제학교,89121,1180,686,1127,686,53,60
청라도,42931,9,89,7,89,2,3
청라도,89127,4,42,4,42,0,1
청라디이스트,42961,161,957,116,957,45,36
청라디이스트,89045,7,38,1,38,6,1
청라디이스트(562동),42962,1878,4010,1847,4010,31,189
청라디이스트(567동),89017,1078,263,1047,263,31,43
청라로데오시티포레안,89419,49,153,49,153,0,6
청라로봇랜드,89246,38,12,34,12,4,1
청라로봇랜드,89247,4,166,0,166,4,5
청라모아미래도아파트604동,89344,1600,922,1595,922,5,81
청라모아미래도아파트정문,89353,137,205,135,205,2,11
청라백세요양병원,42944,128,102,127,102,1,7
청라백세요양병원,89179,108,207,108,207,0,10
청라복합문화센터,89218,122,1400,116,1400,6,49
청라복합문화센터,89219,546,257,516,257,30,25
청라센텀로제비앙,89295,1382,1108,1356,1108,26,80
청라센텀로제비앙,89296,1296,1137,1284,1137,12,78
청라센텀로제비앙정문앞,89346,70,66,70,66,0,4
청라센트럴에일린의뜰,42834,4420,3445,4366,3445,54,253
청라센트럴에일린의뜰104동,42990,4901,1622,4807,1622,94,210
청라센트럴에일린의뜰106동,42892,10023,4998,9802,4998,221,484
청라스타필드,89417,14,24,14,24,0,1
청라스타필드,89418,49,401,49,401,0,14
청라시티프라디움,89334,1555,1682,1520,1682,35,104
청라시티프라디움,89335,2439,821,2353,821,86,105
청라우미린,42862,524,4765,497,4765,27,170
청라우미린아파트,89290,3186,9597,3170,9597,16,412
청라웰카운티221동,89288,61,342,53,342,8,13
청라웰카운티223동,42997,1281,241,1231,241,50,49
청라자이,42742,12831,3709,12556,3709,275,533
청라중앙호수공원입구,89021,12829,9893,12744,9893,85,732
청라중앙호수공원입구,89024,8290,14098,8223,14098,67,722
청라중학교,42848,1423,2102,1394,2102,29,113
청라초등학교,89281,5076,7112,5050,7112,26,393
청라초등학교,89282,5375,6294,5286,6294,89,376
청라파크자이상가,89299,680,1062,645,1062,35,56
청라파크자이상가,89300,649,638,636,638,13,41
청라푸르지오,89217,890,1253,859,1253,31,69
청라한양수자인레이크블루,89348,2707,1541,2636,1541,71,137
청라한양수자인레이크블루,89351,1853,1744,1842,1744,11,116
청라한화꿈에그린,89123,1638,822,1632,822,6,79
청라한화꿈에그린,89124,711,964,691,964,20,54
청라호반베르디움.포리공원,42899,1917,499,1881,499,36,77
청라호반베르디움.포리공원,42919,649,2167,636,2167,13,90
청라호수공원(남측),42861,2848,931,2772,931,76,121
청라호수공원(남측),42863,1368,2397,1314,2397,54,121
청라호수공원한신더휴,42870,6049,613,5741,613,308,214
청라호수공원한신더휴아파트,89291,13409,6708,13197,6708,212,648
청라힐스테이트,42987,844,2810,810,2810,34,117
청라힐스테이트,42988,3611,497,3413,497,198,132
청람중학교,89018,1949,2109,1889,2109,60,130
청람중학교,89019,2388,2290,2355,2290,33,150
청람초등학교,89279,5848,9578,5825,9578,23,497
청람초등학교,89280,9658,7458,9495,7458,163,552
청량중학교,38086,11803,4313,11477,4313,326,519
청련사입구,43766,48,190,47,190,1,7
청련사입구,43841,144,20,141,20,3,5
청룡정,41633,188,6,176,6,12,6
청룡정,41634,3,264,3,264,0,8
청소년수련관,42612,2503,27,2429,27,74,81
청소년수련관,42613,59,2820,18,2820,41,92
청소년수련관,43078,49,25,45,25,4,2
청소년수련관,43079,17,12,17,12,0,0
청소년수련관.어린이과학관,41307,13143,10060,12819,10060,324,748
청소년수련관.어린이과학관,41308,7373,9628,7161,9628,212,548
청송1단지.중흥S클래스,80090,150,144,150,144,0,9
청송1단지.중흥S클래스,80102,515,186,515,186,0,22
청송2.3단지,80089,105,118,104,118,1,7
청송2.3단지,80101,356,111,355,111,1,15
청송마을.성우오스타,80329,104,94,104,94,0,6
청송부락,90092,0,7,0,7,0,0
청송부락,90093,13,0,11,0,2,0
청양골,42775,1,46,1,46,0,1
청운대삼거리(하늘꿈교회),37433,6046,4676,5861,4676,185,345
청운대삼거리(하늘꿈교회),37500,3063,3776,3005,3776,58,220
청운대후문.한전제물포지사,37632,446,1005,428,1005,18,46
청운대후문.한전제물포지사,37633,151,1459,143,1459,8,51
청정주말농장,39852,2,201,2,201,0,6
청천농장,40538,149,1575,145,1575,4,55
청천농장,42511,1265,297,1232,297,33,50
청천농장(종점),40520,3701,41,3611,41,90,120
청천농장입구,40558,462,205,449,205,13,21
청천농장입구,40809,11,639,6,639,5,20
청천도서관,40426,1464,2198,1453,2198,11,118
청천도서관,40427,947,659,908,659,39,51
청천동,40808,336,19,336,19,0,11
청천동무지개아파트,40617,1124,3325,1074,3325,50,143
청천동무지개아파트,40618,3263,919,3231,919,32,134
청천중학교,40449,1543,2528,1492,2528,51,131
청천중학교,40455,1302,2507,1240,2507,62,122
청천천공영주차장,40896,364,1435,354,1435,10,58
청천천공영주차장,41639,356,1465,343,1465,13,58
청천초등학교,40582,3197,5784,3085,5784,112,289
청천초등학교,40586,20532,6249,20122,6249,410,863
청천초등학교,40587,4661,13025,4530,13025,131,570
청천초등학교후문,40574,1489,12422,1457,12422,32,448
청천초등학교후문,40579,13021,1520,12815,1520,206,469
청천치안센터,40533,21637,11768,21129,11768,508,1077
청천치안센터,40537,7452,9324,7267,9324,185,541
청천푸르지오아파트,40488,11240,131,10960,131,280,366
청천푸르지오아파트,40515,13638,1317,13524,1317,114,482
청천푸르지오아파트,40516,1339,9906,1309,9906,30,362
청천푸르지오아파트,40811,7828,1501,7791,1501,37,300
청천푸르지오아파트,40812,734,4613,718,4613,16,172
청천푸르지오아파트,40894,24,2374,24,2374,0,77
청천하우스디아파트,40475,6565,1849,6448,1849,117,271
청천하우스디아파트,40477,873,4515,831,4515,42,173
청학동.한국전력남인천지사,38230,3270,4062,3159,4062,111,236
청학동.한국전력남인천지사,38239,7676,6507,7452,6507,224,457
청학사거리,38256,25034,13744,24563,13744,471,1250
청학사거리,38259,9371,16841,9233,16841,138,845
청학사거리,38509,1520,1816,1509,1816,11,107
청학아파트,38236,9679,5620,9457,5620,222,493
청학아파트,38341,6751,7852,6577,7852,174,471
청학중학교,38160,4055,6069,3927,6069,128,326
청학중학교,38161,3431,2109,3290,2109,141,178
청학중학교,38496,1819,911,1790,911,29,88
청학초등학교,38181,3112,3806,3002,3806,110,223
청학초등학교,38185,3491,3106,3317,3106,174,212
청학초등학교,38190,1652,2733,1546,2733,106,141
체육공원,90214,29,18,29,18,0,1
체육공원앞,35605,2,373,2,373,0,12
체육공원앞,35606,308,2,308,2,0,10
초은고등학교,89025,7671,7127,7620,7127,51,477
초은고등학교,89026,4008,9056,3916,9056,92,421
초정마을,41252,3654,2673,3550,2673,104,204
초정마을,41254,2294,1258,2198,1258,96,114
초지,43016,26,37,26,37,0,2
초지대교,43017,138,474,136,474,2,19
초지대교,43071,1499,358,1414,358,85,59
초지대교,43106,134,688,130,688,4,26
초지리,43026,110,216,72,216,38,10
초지리,43093,2,44,2,44,0,1
초지삼거리,43112,60,26,60,26,0,2
초지삼거리,43147,0,31,0,31,0,1
초지삼거리,43508,5,88,5,88,0,3
초지진,43024,22,104,21,104,1,4
초지진,43025,259,138,247,138,12,12
초지큰말,43260,33,0,33,0,0,1
초지큰말,43512,0,7,0,7,0,0
축현초등학교.인천시립박물관,38151,5016,2930,4920,2930,96,256
축현초등학교.인천시립박물관,38152,2702,4600,2636,4600,66,235
축협,43061,1367,666,1327,666,40,65
충렬사,43326,11,0,8,0,3,0
충렬사,43629,62,22,61,22,1,2
충성아파트,40117,841,2297,819,2297,22,101
충정로역2호선,22064,11943,79,11933,79,10,387
치마바위,43247,0,8,0,8,0,0
치마바위,43646,11,0,9,0,2,0
카페거리,35727,21,23,21,23,0,1
카페거리,35728,6,48,6,48,0,1
칼빈매니토바국제학교,38370,1996,4472,1949,4472,47,208
칼빈매니토바국제학교,38435,3683,708,3446,708,237,141
칼빈매니토바국제학교,38500,4792,3448,4641,3448,151,265
캐슬해모로,39845,733,92,717,92,16,26
캐슬해모로,39846,4644,508,4572,508,72,166
캐슬해모로,39848,336,565,328,565,8,29
캐슬해모로,39849,680,3166,669,3166,11,124
캠퍼스타운역,38419,11276,16740,11167,16740,109,903
캠퍼스타운역,38420,7507,7791,7386,7791,121,493
캠퍼스타운역(3번출구),38388,46,3018,42,3018,4,98
캠퍼스타운역(3번출구),38717,781,33,776,33,5,26
커넬워크,38415,909,2470,895,2470,14,109
커넬워크,38417,2880,1355,2832,1355,48,136
커넬워크(4동),38527,533,1349,515,1349,18,60
컨벤시아,38372,748,2581,727,2581,21,107
코세스물류창고,89197,95,6,87,6,8,3
코스모스아파트,42098,335,1136,323,1136,12,47
코오롱더프라우,38439,198,870,192,870,6,34
코오롱더프라우,38440,886,186,867,186,19,34
코오롱아파트작전중.고.여고,41117,3585,4233,3499,4233,86,252
 쿠팡16 17센터 ,35865,176,242,172,242,4,13
쿠팡물류센터,89157,5,479,5,479,0,15
큐티엘,90218,2,5,2,5,0,0
큰말,43937,20,0,20,0,0,0
큰말,43938,0,10,0,10,0,0
큰말,43949,9,5,8,5,1,0
큰무리선착장,35710,172,226,172,226,0,12
큰무리선착장,35712,520,734,512,734,8,40
큰방죽사거리,39144,2710,3422,2665,3422,45,197
큰방죽사거리,39145,1545,3195,1495,3195,50,152
큰방죽삼거리,39575,94,165,94,165,0,8
큰방죽삼거리,39576,81,467,71,467,10,17
큰산너머입구,44013,7,223,7,223,0,7
큰산너머입구,44014,259,26,257,26,2,9
킹스빌타운,41315,2923,3265,2876,3265,47,199
타운하우스공장.명진화학,89226,5,341,1,341,4,11
타운하우스공장.명진화학,89227,288,7,277,7,11,9
탄토 마을,90381,16,0,15,0,1,0
탄토마을,90378,13,20,13,20,0,1
탑재,43115,15,62,15,62,0,2
탑재,43327,319,262,317,262,2,18
탑재,43579,263,333,257,333,6,19
태경아파트,38275,8428,9257,8140,9257,288,570
태산.대진아파트,38294,2405,2460,2390,2460,15,156
태산아파트,41193,7733,11904,7592,11904,141,633
태산아파트,42227,75,199,75,199,0,8
태산아파트·하나아파트,41578,1355,2069,1342,2069,13,110
태양공단,42147,2574,1499,2558,1499,16,131
태양공단,42148,3351,2060,3275,2060,76,174
태양주택,40204,22,1279,16,1279,6,41
태영아파트,42298,3934,3531,3829,3531,105,240
태영아파트,42300,3855,3752,3719,3752,136,245
태평1차아파트,39241,3785,309,3785,309,0,132
태평1차아파트,39242,215,3798,215,3798,0,129
태평1차아파트,39516,10234,1932,10137,1932,97,392
태평1차아파트,39517,2311,11423,2293,11423,18,443
태평2차아파트,39225,13586,3763,13513,3763,73,559
태평2차아파트,39518,3419,9326,3315,9326,104,411
태평아파트,38083,8173,7291,8023,7291,150,498
태평아파트,41183,1153,181,1114,181,39,43
태평아파트.주안한신휴플러스아파트,37180,2788,4583,2707,4583,81,237
태평아파트.주안한신휴플러스아파트,37183,1370,1945,1309,1945,61,106
태평아파트1차(A),42326,4411,13678,4357,13678,54,583
태평아파트1차(B),42325,12105,4051,11959,4051,146,521
태평아파트2차(A),42317,2241,3554,2211,3554,30,186
태평아파트2차(B),42318,5057,2892,4953,2892,104,256
태평아파트입구,39274,144,1941,143,1941,1,67
태평아파트입구,39276,754,288,746,288,8,33
태평양산업,39066,2499,504,2481,504,18,96
태평양인천물류센터,42012,1700,2460,1698,2460,2,134
태화.두진아파트,39441,9061,6112,8934,6112,127,489
태화두진아파트,39445,7231,7504,7151,7504,80,475
태화아파트,37413,4753,4201,4714,4201,39,288
태화아파트,37416,6698,5247,6576,5247,122,385
태화아파트,40545,9214,3450,9004,3450,210,408
태화아파트,40810,2009,52,1998,52,11,66
태화한진아파트,41132,5098,2562,5088,2562,10,247
태화한진아파트612동,41135,857,2733,831,2733,26,115
택리,43233,48,5,45,5,3,1
택리,43859,3,41,3,41,0,1
택리교회,43229,10,121,9,121,1,4
택리교회,43860,132,23,129,23,3,5
테니스장,40456,246,301,242,301,4,17
테일코리아,89430,221,45,221,45,0,8
테일코리아,89431,480,150,479,150,1,20
테크노파크IT센타,39726,869,2490,854,2490,15,108
테크노파크IT센타,39727,3021,2215,2853,2215,168,168
테크노파크IT센터,39938,3255,5495,3128,5495,127,282
테크노파크역,38421,28568,15653,28205,15653,363,1426
테크노파크역,38422,25892,26978,25539,26978,353,1705
토지금고,37114,8373,2192,8202,2192,171,340
토지금고,37115,4007,11802,3892,11802,115,509
토지금고시장,37102,18338,14886,17925,14886,413,1071
토지금고시장앞,37509,11249,10626,11095,10626,154,705
트러스(서구장애인직업재활시설),42809,595,2,566,2,29,19
트러스(서구장애인직업재활시설),42810,1,376,1,376,0,12
트레지움1단지.다니엘병원,55076,2921,1027,2872,1027,49,127
트레지움1단지.다니엘병원,55077,903,2274,899,2274,4,102
트루엘에코시티아파트(후문),42049,1680,1000,1654,1000,26,86
트루엘에코시티아파트(후문),42050,1304,1431,1277,1431,27,88
파라곤보타닉파크,89422,1174,14,1164,14,10,38
파라다이스공원,43391,149,43,146,43,3,6
파라다이스공원,43828,47,198,43,198,4,7
파라다이스시티역,35748,0,38,0,38,0,1
팔도주유소,40175,304,292,283,292,21,19
팔도주유소,40774,10461,7175,10272,7175,189,568
팬더아파트,39968,389,4,385,4,4,12
팬더아파트,39980,3,350,3,350,0,11
펜션마을,90392,3,30,3,30,0,1
펜션마을,90393,10,1,10,1,0,0
평전,43258,0,55,0,55,0,1
평화전망대,43743,52,77,51,77,1,4
평화전망대,43760,44,10,44,10,0,1
포내교회,35875,0,5,0,5,0,0
포도마을,55039,2589,2905,2566,2905,23,177
포도마을사거리.현대백화점.이마트,55055,9345,9534,9245,9534,100,609
포도밭,43939,11,5,11,5,0,0
포도밭,43940,13,8,12,8,1,0
포레시안101동앞,39729,6282,5628,6144,5628,138,384
포레시안101동앞,39730,4358,3684,4269,3684,89,259
포스코타워앤쉐라톤호텔,38491,2926,1396,2864,1396,62,139
푸르지오더베뉴(3216동),89442,516,1901,514,1901,2,77
푸르지오더베뉴후문,89423,13,1482,11,1482,2,48
푸르지오더스카이,35844,2612,1235,2579,1235,33,124
푸르지오더스카이,35845,1684,1364,1640,1364,44,98
푸르지오더스카이256동,35508,2007,593,1931,593,76,83
푸르지오더스카이256동,35509,1174,1394,1103,1394,71,82
푸르지오월드마크,,7629,10553,7414,10553,215,586
푸르지오하버뷰,38456,205,522,191,522,14,23
푸르지오하버뷰,38522,1174,3306,1119,3306,55,144
푸른초장,90052,1,174,0,174,1,5
푸른초장,90053,133,4,128,4,5,4
풍류산,90129,0,18,0,18,0,0
풍류산,90130,43,0,40,0,3,1
풍림1단지정문,70007,9,945,9,945,0,30
풍림1차205동,35255,2504,4955,2451,4955,53,240
풍림1차205동,35256,7684,3471,7584,3471,100,359
풍림1차아파트,42969,13187,5391,13082,5391,105,599
풍림1차아파트,42970,4419,10975,4313,10975,106,496
풍림2.3차아파트,38350,11091,2221,11009,2221,82,429
풍림2단지,70010,9,1559,9,1559,0,50
풍림2차아파트,38049,5144,14379,5075,14379,69,629
풍림2차아파트,38050,8101,5672,7845,5672,256,444
풍림3단지정문,70003,163,295,145,295,18,14
풍림3차아파트,42366,9019,4855,8980,4855,39,447
풍림6단지,35124,2281,358,2181,358,100,85
풍림아이원,36114,207,2032,199,2032,8,72
풍림아이원,36115,7907,1812,7755,1812,152,313
풍림아이원,36121,2488,9344,2441,9344,47,381
풍림아이원,41441,4258,2179,4170,2179,88,207
풍림아이원1차·금호어울림아파트,42642,5858,21,5722,21,136,189
풍림아이원1차·금호어울림아파트,42646,31,5235,23,5235,8,169
풍림아이원2차아파트,42485,12640,61,12370,61,270,409
풍림아이원4차아파트,42645,11,4661,9,4661,2,150
풍림아이원아파트,37034,20144,9113,19620,9113,524,943
풍림아파트,36122,6846,568,6650,568,196,239
풍림아파트,37245,26953,7605,26398,7605,555,1114
풍림아파트,37246,6569,13164,6461,13164,108,636
풍림아파트,38255,3905,5196,3867,5196,38,293
풍림아파트,39162,9096,13440,8967,13440,129,726
풍림아파트,39163,14792,6697,14648,6697,144,693
풍림아파트,41374,2766,2777,2729,2777,37,178
풍림아파트,70008,685,11,665,11,20,22
풍림아파트(소래마을),39120,1209,3687,1174,3687,35,157
풍림아파트104동,40898,7696,6498,7524,6498,172,457
풍림아파트104동,40899,4984,5738,4963,5738,21,345
풍림아파트상가,70043,336,438,306,438,30,24
풍림아파트상가,70044,534,182,503,182,31,23
풍림엑슬루타워,42830,5709,7979,5677,7979,32,441
풍무역,80167,303,5914,302,5914,1,200
풍무역,80168,4167,351,4165,351,2,145
풍물시장,35054,489,1201,430,1201,59,54
풍물시장,35055,209,13,202,13,7,7
풍물시장,43941,79,8015,59,8015,20,261
풍산빌라 입구,90384,3,0,3,0,0,0
풍산특수금속,90219,6,5,6,5,0,0
프라임,39643,5371,1428,5327,1428,44,219
프리상뜨아파트,40230,124,4894,110,4894,14,161
프린피아통합물류센터,89235,240,4,235,4,5,7
하나개삼거리,35733,18,23,18,23,0,1
하나개삼거리,35734,6,14,6,14,0,0
하나개해수욕장,35737,1422,892,1409,892,13,74
하나글로벌캠퍼스,89444,88,259,83,259,5,11
하나글로벌캠퍼스,89445,104,3393,100,3393,4,112
하나금융그룹통합데이터센터,89265,181,1740,181,1740,0,61
하나금융그룹통합데이터센터,89294,232,130,225,130,7,11
하나로쇼핑,37118,3556,7514,3344,7514,212,357
하나아파트,37052,9270,2901,9117,2901,153,392
하나아파트,40546,1190,1440,1187,1440,3,84
하나아파트,41250,5775,6919,5661,6919,114,409
하나아파트,41574,1837,17,1810,17,27,59
하늘도시중심상가,35821,2231,360,2079,360,152,83
하늘도시중심상가,35822,452,2305,441,2305,11,88
하늘문화센터,35826,2,35,2,35,0,1
하늘문화센터,35827,35,4,35,4,0,1
하늘문화센터입구,35766,2,56,2,56,0,1
하늘문화센터입구,35767,14,4,14,4,0,0
하늘중학교,35823,569,1496,551,1496,18,66
하늘초등학교후문,35499,429,253,420,253,9,22
하늘초등학교후문,35500,102,966,94,966,8,34
하늘휴게소,70220,2816,10891,2810,10891,6,442
하늘휴게소,70221,10171,2742,10159,2742,12,416
하룩,43157,62,195,56,195,6,8
하룩,43281,230,57,221,57,9,9
하리마을회관,90243,0,16,0,16,0,0
하리마을회관,90244,15,0,12,0,3,0
하리선착장,90240,4,30,4,30,0,1
하야동,41438,591,776,579,776,12,44
하야동,41439,800,1093,789,1093,11,61
하얀마을,55035,2567,2635,2548,2635,19,167
하얀집민박,43440,24,6,24,6,0,0
하얀집민박,43497,2,14,2,14,0,0
하얏트호텔,35028,933,7332,908,7332,25,266
하얏트호텔,35206,1440,3412,1406,3412,34,156
하우고개,43275,31,145,29,145,2,5
하우고개,43577,188,45,152,45,36,7
하우스앞,43174,41,0,41,0,0,1
하우스앞,43231,0,30,0,30,0,0
하우스토리,41569,205,310,169,310,36,16
하우스토리,41570,138,1579,105,1579,33,55
하우스토리,41606,523,555,510,555,13,34
하우스토리,41626,758,463,757,463,1,39
하우스토리만수아파트,39301,1606,1068,1547,1068,59,86
하일부락입구,43967,0,3,0,3,0,0
하일부락입구,43971,2,3,2,3,0,0
하점공단,43448,3,33,2,33,1,1
하점공단,43755,19,43,16,43,3,2
하점면사무소,43738,307,113,295,113,12,13
하점면사무소,43834,95,256,89,256,6,11
하점순복음교회,90222,176,2,170,2,6,5
하점순복음교회,90223,1,59,1,59,0,1
하점우체국,43817,627,70,574,70,53,22
하점우체국,43838,74,724,71,724,3,25
하점초등학교,43739,1,71,1,71,0,2
하점초등학교,43836,164,7,135,7,29,5
하정초등학교,40044,976,474,939,474,37,46
하정초등학교,40046,82,509,81,509,1,19
학마을서원아파트,41652,169,105,168,105,1,8
학마을한진아파트정문,41293,2103,3161,2077,3161,26,169
학산사거리,37025,6774,280,6580,280,194,227
학산사거리,37027,245,3541,229,3541,16,122
학산사거리,37562,1649,1415,1600,1415,49,98
학산소극장,37169,19554,2980,19379,2980,175,726
학산소극장,37173,6844,17427,6754,17427,90,782
학생안전체험관,39284,2049,4422,1963,4422,86,208
학익.원흥아파트,37015,1873,55,1811,55,62,62
학익2동행정복지센터,37150,13314,6738,12853,6738,461,646
학익2동행정복지센터,37151,7501,14322,7290,14322,211,703
학익고등학교,37029,10897,3097,10610,3097,287,451
학익고등학교,37505,3149,10751,2989,10751,160,448
학익동구치소,37139,166,851,164,851,2,32
학익동성당앞,37630,1474,27,1426,27,48,48
학익동성당앞,37631,104,698,102,698,2,25
학익사거리,37058,11,393,11,393,0,13
학익사거리,37075,3169,1532,3103,1532,66,151
학익사거리,37077,2159,6281,2086,6281,73,272
학익사거리(동아풍림아파트),37084,12711,5055,12442,5055,269,573
학익사거리(동아풍림아파트),37089,10671,10966,10395,10966,276,697
학익시장,37106,15597,5355,15286,5355,311,675
학익시장,37112,4036,13806,3916,13806,120,575
학익시장(법원검찰청),37080,10719,4777,10462,4777,257,499
학익시장앞,37082,4740,5555,4613,5555,127,332
학익여자고등학교,37140,701,1262,687,1262,14,63
학익여자고등학교,37566,504,1156,500,1156,4,53
학익풍림아파트,37487,15,2675,13,2675,2,86
한가라지고개,90157,7,5,7,5,0,0
한가라지고개,90158,3,13,3,13,0,0
한가라지입구,90159,9,5,9,5,0,0
한가라지입구,90160,10,7,10,7,0,0
한가람마을우미린.호수이편한세상,80318,968,3321,961,3321,7,138
한강센트럴블루힐.모아엘가2차,80375,294,348,288,348,6,20
한국가스공사,39061,680,758,665,758,15,46
한국가스공사,89273,191,560,186,560,5,24
한국가스공사,89274,104,578,104,578,0,22
한국가스공사인천지역본부,89114,28,49,22,49,6,2
한국가스공사인천지역본부,89115,21,41,21,41,0,2
한국건설생활환경시험연구원,39312,505,405,489,405,16,29
한국건설생활환경시험연구원,39315,779,3052,769,3052,10,123
한국공항공사,25002,86,1391,85,1391,1,47
한국공항공사,25144,21,61,21,61,0,2
한국국토정보공사인천북부지사,42278,5520,6577,5399,6577,121,390
한국국토정보공사인천북부지사,42280,6616,3375,6468,3375,148,322
한국글로벌셰프고등학교,43246,199,180,186,180,13,12
한국글로벌셰프고등학교,43381,43,98,40,98,3,4
한국도심공항터미널,35400,3,96,3,96,0,3
한국도심공항터미널,35408,24,124,20,124,4,4
한국도심공항터미널,35417,64,22,63,22,1,2
한국도심공항터미널앞,35645,73,15,63,15,10,2
한국마쓰이,39055,1058,1538,1055,1538,3,83
한국마쓰이,39057,3970,1646,3958,1646,12,181
한국만화박물관,40583,5325,11381,5232,11381,93,538
한국무역센터.삼성역,23201,2443,7,2443,7,0,79
한국무역센터.삼성역,23251,170,1956,170,1956,0,68
한국산업단지공단,39060,959,63,958,63,1,32
한국산업단지공단,39067,50,930,48,930,2,31
한국생산기술연구원,38448,340,561,321,561,19,29
한국생산기술연구원(주조기술센터),42271,354,627,354,627,0,31
한국생산기술연구원(주조기술센터),42719,359,270,357,270,2,20
한국샤프(로얄금속),40600,2567,3892,2554,3892,13,208
한국선교역사기념관,40673,2135,765,2058,765,77,93
한국아파트,37017,1763,8619,1731,8619,32,334
한국아파트,38154,3016,1564,2942,1564,74,147
한국아파트,40714,126,2458,116,2458,10,83
한국아파트,40715,3305,110,3289,110,16,110
한국아파트,40790,15671,16392,15453,16392,218,1034
한국아파트,40791,16240,11949,16011,11949,229,909
한국아파트,40792,3870,14143,3781,14143,89,581
한국아파트,40816,12093,10019,11924,10019,169,713
한국아파트,41206,6669,3999,6560,3999,109,344
한국아파트,41208,2685,4595,2613,4595,72,234
한국아파트,80057,2504,35,2500,35,4,81
한국전력,42947,75,875,74,875,1,30
한국지엠청라주행시험장,89412,189,358,178,358,11,17
한국지엠청라주행시험장,89413,326,240,325,240,1,18
한국지엠출고문,40560,3750,7332,3673,7332,77,357
한국지엠출고문,40570,5380,3778,5326,3778,54,295
한국콘베어공업,92049,13,0,13,0,0,0
한국타이어인천물류센터,89221,516,1325,500,1325,16,59
한국타이어인천물류센터,89222,556,919,540,919,16,47
한국특수주물(주),42575,401,325,387,325,14,23
한국폴리텍2대학남인천캠퍼스,37448,1020,950,1010,950,10,63
한국폴리텍2대학남인천캠퍼스,37450,711,524,698,524,13,39
한남시티플라자,40253,22692,12023,22315,12023,377,1119
한들마을입구(유아교육진흥원),42370,788,4079,763,4079,25,157
한들마을입구(유아교육진흥원),42371,2060,1005,2004,1005,56,98
한라비발디,35459,8387,2958,8174,2958,213,365
한라비발디,35460,7195,14764,6975,14764,220,708
한라비발디,42878,760,28,759,28,1,25
한라비발디,42879,19,373,19,373,0,12
한라비발디,89180,1840,1397,1815,1397,25,104
한라비발디,89181,1745,2689,1650,2689,95,143
한라비발디정문,89373,54,1392,45,1392,9,46
한라비발디후문.화성파크드림,35658,683,1546,599,1546,84,71
한라시멘트,35291,112,481,93,481,19,19
한라아파트,39117,1162,4579,1114,4579,48,185
한라아파트,39118,6185,1768,5893,1768,292,256
한림병원,41130,13122,9174,12959,9174,163,719
한림병원,41131,10115,15504,9996,15504,119,826
한미반도체,42754,755,1381,747,1381,8,68
한미반도체,42755,217,317,214,317,3,17
한빛초교앞,39773,1500,7972,1463,7972,37,305
한빛초교앞,39774,6890,2726,6840,2726,50,310
한사랑어린이집,42461,16,76,16,76,0,2
한성아파트,89020,748,1409,747,1409,1,69
한성자동차학원,42091,380,808,379,808,1,38
한수조경,43681,5,14,5,14,0,0
한수조경,43882,8,8,5,8,3,0
한스엔지니어링,42276,366,162,358,162,8,17
한스엔지니어링,42279,388,536,387,536,1,29
한신더휴스카이파크,35654,1358,1333,1249,1333,109,86
한신더휴스카이파크,35655,2788,888,2742,888,46,118
한신더휴테라스,35761,73,52,73,52,0,4
한신더휴테라스,35762,11,68,9,68,2,2
한신빌리지(A),42249,785,2722,778,2722,7,113
한신빌리지(B),42246,4242,862,4176,862,66,164
한신빌리지(C),42229,2673,613,2642,613,31,106
한신빌리지아파트,42230,520,1105,507,1105,13,52
한신삼부아파트,40806,2046,2982,2015,2982,31,162
한신아파트,37262,5402,4078,5362,4078,40,305
한신아파트,37264,8802,10179,8630,10179,172,612
한신아파트,37267,13241,9803,13057,9803,184,743
한신아파트,41066,1955,1525,1942,1525,13,112
한신아파트,41067,2134,1613,2108,1613,26,120
한신아파트,42095,30,1040,26,1040,4,34
한신휴아파트,40245,4102,212,4045,212,57,139
한신휴아파트,42105,42344,18312,41662,18312,682,1956
한신휴아파트,42106,3189,2295,3113,2295,76,176
한양2차아파트,37512,13580,4668,13344,4668,236,588
한양2차아파트,38055,5697,4003,5563,4003,134,312
한양2차아파트37동,38058,1737,1138,1720,1138,17,92
한양공구,39664,109,3,107,3,2,3
한양공구,39753,1,77,1,77,0,2
한양공구,42071,917,7540,914,7540,3,272
한양쇼핑,40331,1432,8785,1357,8785,75,329
한양쇼핑,40333,6527,3628,6403,3628,124,327
한양수자인,35450,2434,389,2312,389,122,91
한양수자인,42868,4897,2450,4818,2450,79,237
한양수자인,42893,3445,3391,3296,3391,149,220
한양수자인(후문),35537,3123,566,3065,566,58,119
한양아파트,37076,2018,5634,1986,5634,32,246
한양아파트,37079,5716,666,5621,666,95,205
한양아파트,40269,490,268,466,268,24,24
한양아파트,40310,16925,4629,16709,4629,216,695
한양아파트,40356,17395,10933,17206,10933,189,913
한양아파트,40905,49,461,49,461,0,16
한양아파트2차,38062,3850,6309,3745,6309,105,327
한양화학,42523,3357,1065,3291,1065,66,142
한일베라체,42839,6317,1235,6152,1235,165,243
한일베라체,42865,1262,2700,1220,2700,42,127
한일베라체,42948,4599,1910,4524,1910,75,209
한일아파트,41295,1057,2257,1026,2257,31,106
한일아파트,41296,2140,1108,2044,1108,96,104
한일아파트,80195,89,1657,89,1657,0,56
한일튜브(주),42576,519,391,514,391,5,29
한전사택,44090,30,40,29,40,1,2
한전사택,44197,2,0,2,0,0,0
한전온수출장소,43012,285,394,265,394,20,21
한주글로벌,89306,10,373,10,373,0,12
한진,38540,3,315,2,315,1,10
한진,38541,286,2,282,2,4,9
한진아파트,38016,29019,17626,28809,17626,210,1504
한진아파트,41355,208,488,203,488,5,22
한진아파트후문,41300,2498,536,2495,536,3,97
한풍산업,39014,409,808,402,808,7,39
한화2차,40363,3369,1475,3279,1475,90,156
한화꿈에그린,42860,1248,393,1213,393,35,52
한화꿈에그린,42872,349,1084,328,1084,21,46
한화꿈에그린정문,89372,2710,1843,2642,1843,68,146
한화아파트,40351,13393,8934,13167,8934,226,720
한화아파트,40379,2743,1959,2709,1959,34,151
한화아파트,40380,4086,2262,4018,2262,68,204
한화아파트,41375,4714,3091,4560,3091,154,251
한화지구공원앞,39654,1667,1050,1578,1050,89,87
한희빌딩,39311,1905,5547,1801,5547,104,240
함박도서관,38286,4137,2509,4059,2509,78,214
함박도서관,38742,277,1462,274,1462,3,56
함박마을,38277,5721,2247,5503,2247,218,257
함박마을문화복지센터,38291,3327,1599,3264,1599,63,158
함박마을문화복지센터,38741,234,1758,229,1758,5,64
함박마을입구,38285,2918,9262,2795,9262,123,392
함허동천,43352,14,108,14,108,0,3
함허동천,43403,152,21,149,21,3,5
합동청사역,35207,21470,3376,21306,3376,164,801
합정역,14220,185,14025,185,14025,0,458
합정역,23029,372,38028,372,38028,0,1238
합정역,23030,45993,701,45906,701,87,1506
항동7가버스차고지,35609,1173,21,818,21,355,38
항동7가버스차고지,35610,612,771,74,771,538,44
항동7가버스차고지(삼거리),35704,457,545,10,545,447,32
항동7가버스차고지(삼거리),35705,1086,17,889,17,197,35
항운아파트,35065,16625,4149,16260,4149,365,670
항운아파트,35481,1196,8879,1139,8879,57,325
항운아파트,35602,310,2008,304,2008,6,74
항진축산,39056,751,1788,745,1788,6,81
항진축산,39058,1903,1012,1892,1012,11,94
항청리종점,43558,138,101,120,101,18,7
항포,90247,0,1,0,1,0,0
항포,90248,50,2,50,2,0,1
해광병원,40292,80,2563,78,2563,2,85
해넘이마을,90135,24,10,24,10,0,1
해넘이마을,90136,33,40,33,40,0,2
해돋이공원,38008,72,276,70,276,2,11
해돋이공원,38010,499,881,486,881,13,44
해돋이공원,38718,62,64,62,64,0,4
해돋이도서관,38729,207,56,203,56,4,8
해돋이도서관,38730,18,547,16,547,2,18
해뜨는집앞,35531,18,39,16,39,2,1
해뜨는집앞,35726,68,6,68,6,0,2
해망,90352,1,4,1,4,0,0
해망,90353,18,7,18,7,0,0
해맞이공원앞,35616,243,650,243,650,0,28
해맞이공원앞,35617,406,137,397,137,9,17
해명초등학교앞,90179,11,17,10,17,1,0
해명초등학교앞,90180,38,165,37,165,1,6
해모로월드뷰,39794,1085,364,1028,364,57,46
해모로월드뷰,39805,490,701,469,701,21,38
해물탕거리,40782,3669,1984,3523,1984,146,182
해병2사단.향동,80054,898,609,869,609,29,48
해사고등학교,35503,1849,22,1800,22,49,60
해사고등학교.한국이민사박물관,35126,37,3013,36,3013,1,98
해서초등학교,41166,832,714,817,714,15,49
해서초등학교,41168,545,1500,524,1500,21,65
해성단조,42813,119,0,116,0,3,3
해송노인요양병원,35552,4,47,2,47,2,1
해송노인요양병원,35553,12,0,8,0,4,0
해수워터피아,42082,4072,647,4020,647,52,152
해수워터피아,42083,1674,7023,1674,7023,0,280
해안도로신항만교,39001,241,678,239,678,2,29
해안도로신항만교,39002,779,507,768,507,11,41
해암약수,90161,17,19,16,19,1,1
해암약수,90162,3,27,3,27,0,0
해양경찰청,38014,1092,3588,1032,3588,60,150
해양경찰청,38015,6815,3563,6723,3563,92,334
해양경찰청,38411,8577,6464,8477,6464,100,485
해양기계,39532,38,38,37,38,1,2
해양기계,39696,11,155,11,155,0,5
해오름민박,43413,44,57,41,57,3,3
해오름민박,43442,53,56,53,56,0,3
해원고등학교,42964,38,706,38,706,0,24
해원중학교,42972,2023,63,1868,63,155,67
해원중학교,42973,85,886,75,886,10,31
해원중학교후문,42965,1750,464,1655,464,95,71
해피타운앞,44139,9,3,9,3,0,0
해피타운앞,44198,48,86,43,86,5,4
해피하임.기업은행앞,42738,25,1617,25,1617,0,52
핸즈코퍼레이션,89262,30,2416,17,2416,13,78
핸즈코퍼레이션,89263,31,79,23,79,8,3
햇내로공원입구,35777,31,3,31,3,0,1
햇내로공원입구,35784,0,51,0,51,0,1
행복마을입구,35687,22,8,22,8,0,0
행복마을입구,35690,26,66,26,66,0,2
행자골,43350,0,8,0,8,0,0
행자골,43583,22,5,19,5,3,0
행정복지센터사거리,40332,660,3120,646,3120,14,121
향나무골,43131,31,9,30,9,1,1
향나무골,43648,31,27,31,27,0,1
향동해병2사단,80055,833,1756,819,1756,14,83
향촌휴먼시아2단지,39741,9378,15724,9277,15724,101,809
허브주유소,35446,328,494,321,494,7,26
허브주유소,35447,443,5547,426,5547,17,193
허튼개,90119,0,8,0,8,0,0
허튼개,90120,5,2,5,2,0,0
헤나무,43199,5,39,5,39,0,1
헤나무,43317,58,3,57,3,1,1
혁이네슈퍼,40738,60,733,39,733,21,25
혁이네슈퍼,40739,348,60,319,60,29,13
현광아파트,37007,1938,8,1911,8,27,62
현광아파트,37488,15,2431,5,2431,10,78
현광아파트,39380,17131,17841,16888,17841,243,1128
현광아파트,41071,5978,1741,5887,1741,91,249
현광아파트,41432,3378,5928,3322,5928,56,300
현광아파트,42258,128,765,123,765,5,28
현광아파트,42260,736,225,729,225,7,31
현광아파트(호산부인과),39376,33000,16264,32559,16264,441,1589
현광아파트후문,37560,3110,14,3070,14,40,100
현광아파트후문앞,37559,128,1524,5,1524,123,53
현대.태화아파트,41402,270,3802,258,3802,12,131
현대102동,40146,2992,1081,2950,1081,42,131
현대121동,40137,5958,874,5861,874,97,220
현대1단지관리사무소,40740,339,2792,332,2792,7,101
현대1차아파트,38061,7211,4111,7023,4111,188,365
현대1차아파트,41365,9425,618,9360,618,65,323
현대1차아파트정문,41367,76,295,68,295,8,11
현대207동,40168,716,10175,692,10175,24,351
현대209동,40167,10952,672,10740,672,212,374
현대2차아파트,38173,2254,2969,2208,2969,46,168
현대2차아파트,41106,840,4154,830,4154,10,161
현대2차아파트,41112,8694,556,8538,556,156,298
현대2차아파트,41366,519,5674,509,5674,10,199
현대2차아파트정문,41364,457,6455,454,6455,3,222
현대310동(서중학교),40097,1357,3104,1289,3104,68,143
현대3단지,40127,7000,6507,6870,6507,130,435
현대3단지,40129,8355,7921,8215,7921,140,525
현대3차아파트,38168,19441,12090,18730,12090,711,1017
현대3차아파트,38342,18613,18391,18148,18391,465,1193
현대4차아파트,38158,2061,2258,1999,2258,62,139
현대4차아파트,38183,2871,4180,2795,4180,76,227
현대4차아파트,38186,3944,1507,3838,1507,106,175
현대5차,40405,12145,6907,11946,6907,199,614
현대5차,40408,7096,4793,6994,4793,102,383
현대5차아파트,38176,3877,1523,3699,1523,178,174
현대동부시장,36041,11672,5341,11223,5341,449,548
현대모닝.임광그대가아파트,39579,7820,3008,7767,3008,53,349
현대백화점,22003,5179,36,5173,36,6,168
현대슈퍼,43376,229,10,223,10,6,7
현대슈퍼,43617,8,41,7,41,1,1
현대시장,36042,11639,6585,11270,6585,369,587
현대시장,36043,6836,8831,6589,8831,247,505
현대시장,36118,7555,10443,7358,10443,197,580
현대써비스,42021,3942,3014,3923,3014,19,224
현대아파트,35396,136,11,136,11,0,4
현대아파트,37154,3370,9081,3303,9081,67,401
현대아파트,37161,8506,3682,8364,3682,142,393
현대아파트,39267,5828,5521,5738,5521,90,366
현대아파트,39271,6206,3266,6085,3266,121,305
현대아파트,40112,38656,27061,37852,27061,804,2119
현대아파트,40681,2223,7300,2152,7300,71,307
현대아파트,40682,8342,1964,8233,1964,109,332
현대아파트,40737,1183,2789,1174,2789,9,128
현대아파트,40788,38816,35927,38238,35927,578,2411
현대아파트,43082,31,475,31,475,0,16
현대아파트,43083,447,140,438,140,9,18
현대아파트.통진도서관,80135,104,1027,99,1027,5,36
현대아파트.통진도서관,80136,1028,190,1019,190,9,39
현대아파트105동,40734,183,1335,174,1335,9,48
현대아파트105동,40735,993,383,988,383,5,44
현대아파트113동,40105,10562,5927,10368,5927,194,531
현대아파트116동,40732,1858,490,1838,490,20,75
현대아파트119동,40733,74,2659,72,2659,2,88
현대아파트120동앞,40140,436,5293,428,5293,8,184
현대오일뱅크,41459,1875,1180,1865,1180,10,98
현대자동차빌딩앞,40103,6137,13465,5968,13465,169,632
현대자동차서비스,42032,7497,2251,7449,2251,48,314
현대자동차서비스,42033,12063,6678,11992,6678,71,604
현대제철,36086,718,1175,699,1175,19,61
현대제철,36123,3059,645,3008,645,51,119
현대제철정문,36133,528,1298,512,1298,16,58
현대철강레이져,90220,2,2,2,2,0,0
현대철강레이져,90221,17,0,17,0,0,0
현송중학교,38744,1052,366,1036,366,16,45
현송중학교,38745,510,734,494,734,16,40
형제마트,40004,589,2045,574,2045,15,84
형제마트,40006,1804,614,1767,614,37,78
혜덕,90217,18,2,18,2,0,0
혜성프라자,40393,25596,14378,25127,14378,469,1289
혜성프라자,40395,15857,18376,15543,18376,314,1104
호구포역,39784,6483,7284,6416,7284,67,444
호구포역,39785,10141,8943,10072,8943,69,615
호구포역2번출구,92040,1278,219,1274,219,4,48
호명사입구,40093,7,424,2,424,5,13
호박골,43437,39,51,38,51,1,2
호박골,43784,53,29,50,29,3,2
호박골사거리,43123,8,41,7,41,1,1
호박골사거리,43124,51,7,48,7,3,1
호박골사거리,43706,8,213,8,213,0,7
호박골사거리,43804,75,11,72,11,3,2
호반베르디움,42855,365,5268,334,5268,31,181
호반베르디움14단지,42880,1049,4587,963,4587,86,181
호반베르디움214동앞,42998,226,801,211,801,15,33
호반베르디움2차,89112,1705,1325,1658,1325,47,97
호반베르디움2차,89113,1206,1178,1188,1178,18,76
호반베르디움3차아파트,42743,2801,7987,2732,7987,69,348
호반베르디움3차아파트,42908,1360,5626,1274,5626,86,225
호반베르디움아파트,39922,2515,1582,2470,1582,45,132
호반베르디움아파트107동,92011,2945,154,2905,154,40,99
호반써밋1차 3101동,89393,820,2036,810,2036,10,92
호반써밋1차 3101동,89394,1872,409,1809,409,63,73
호반써밋송도,38637,3530,136,3474,136,56,118
호반써밋송도(109동),38634,116,256,114,256,2,12
호불사입구,38180,2368,3661,2296,3661,72,194
호불사입구,38182,3524,2025,3447,2025,77,179
호세요양원,43221,59,130,59,130,0,6
호세요양원,43311,6,10,5,10,1,0
호수공원,89103,236,803,221,803,15,33
호수공원,89104,2729,1012,2687,1012,42,120
호수공원음악분수,89027,1762,898,1676,898,86,85
호수공원음악분수,89028,879,1949,865,1949,14,91
호수마을5단지후문,35270,38,42,33,42,5,2
호수마을5단지후문,35735,58,79,57,79,1,4
호수마을이편한세상.한가람우미린,80319,1301,548,1270,548,31,59
홈씨씨인천점,89188,282,740,278,740,4,32
홈플러스,80070,216,3241,214,3241,2,111
홈플러스,89225,465,358,451,358,14,26
홈플러스,35218,286,1308,280,1308,6,51
홈플러스.산림조합,80018,4046,124,4041,124,5,134
홈플러스계산점,41622,42,1305,37,1305,5,43
홍대입구역,23011,124,9577,124,9577,0,312
홍대입구역,23031,52826,560,52723,560,103,1722
홍대입구역,23032,469,24504,469,24504,0,805
홍예문·공영주차장,35794,29,491,26,491,3,16
홍예문·공영주차장,35806,87,440,86,440,1,17
홍의사거리,43798,63,30,61,30,2,3
홍의사거리,43813,45,44,44,44,1,2
홍의삼거리,43441,15,38,15,38,0,1
홍의삼거리,43613,73,41,70,41,3,3
홍익자원,35514,1388,570,1373,570,15,63
홍익자원,35515,61,942,41,942,20,32
홍현마을,90002,47,8,44,8,3,1
홍현마을,90003,7,37,6,37,1,1
화개사입구,90034,1,96,1,96,0,3
화개사입구,90035,128,0,114,0,14,4
화곡역,16147,142,38504,140,38504,2,1246
화곡역,25190,36345,94,36212,94,133,1175
화도,43077,62,120,54,120,8,5
화도고개,36027,2263,2873,2165,2873,98,165
화도고개,36028,1841,4745,1783,4745,58,212
화도돈대,43676,46,0,44,0,2,1
화도돈대,43863,4,49,4,49,0,1
화도진공원.화도진도서관,36033,11762,3626,11538,3626,224,496
화도진공원.화도진도서관,36035,4210,11692,4112,11692,98,512
화도진중학교,36064,3184,601,3009,601,175,122
화도진중학교,36066,833,3014,752,3014,81,124
화도터미널,43104,1033,1626,957,1626,76,85
화도터미널,43105,1986,1043,1898,1043,88,97
화력발전소,42628,191,196,191,196,0,12
화문석문화관,43697,145,1,136,1,9,4
화물터미널,35039,4,279,4,279,0,9
화물터미널,35040,275,8,271,8,4,9
화성보일러,39107,2888,5712,2860,5712,28,277
화성파크드림.스카이시티자이,35651,6311,2033,6197,2033,114,269
화성파크드림후문.한라비발디,35659,566,913,546,913,20,47
화수부두,36147,594,964,548,964,46,50
화수사거리,36072,2433,616,2370,616,63,98
화수사거리,36104,225,1281,216,1281,9,48
화전초교사거리,41087,917,1154,909,1154,8,66
화전초등학교,41085,1111,384,1095,384,16,48
화전초등학교,41086,459,558,437,558,22,32
화평철교.화평동냉면거리,36014,2945,3361,2875,3361,70,203
화평철교.화평동냉면거리,36016,16573,22892,16060,22892,513,1273
화훼단지·당미교,41462,113,462,113,462,0,18
화훼단지·당미교,41463,201,174,201,174,0,12
환경공단강화사업소,90109,2,7,2,7,0,0
환경공단강화사업소,90110,1,0,1,0,0,0
황곡노인정,89310,95,0,84,0,11,3
황곡노인정,89320,70,121,52,121,18,6
황곡상회,89311,46,0,43,0,3,1
황곡상회,89330,3,47,3,47,0,1
황골,43992,29,78,25,78,4,3
황골,43993,87,8,82,8,5,3
황골마을,43135,9,26,9,26,0,1
황골마을,43277,53,1,52,1,1,1
황련사입구,43328,66,41,64,41,2,3
황련사입구,43630,54,0,54,0,0,1
황산도,43635,4,34,1,34,3,1
황산도관광밸트,43873,11,0,11,0,0,0
황산도관광밸트,43876,3,25,3,25,0,0
황산도입구,43636,40,6,36,6,4,1
황산도입구,43861,16,12,13,12,3,0
황청리종점,90207,6,0,6,0,0,0
효성2동치안센터,41024,2028,9513,1955,9513,73,372
효성고등학교,41074,2051,730,2003,730,48,89
효성고등학교,41075,728,2693,713,2693,15,110
효성남초등학교,41040,6234,3281,6127,3281,107,306
효성노인문화센터,41409,748,1854,727,1854,21,83
효성노인문화센터,41410,459,940,452,940,7,45
효성농협,41039,2785,1557,2712,1557,73,140
효성뉴서울아파트,41060,16848,1685,16587,1685,261,597
효성뉴서울아파트,41061,2427,14935,2326,14935,101,560
효성뉴서울아파트202동,41078,1594,17990,1538,17990,56,631
효성뉴서울아파트204동,41368,16033,1692,15891,1692,142,571
효성대신아파트,41041,6077,2807,5890,2807,187,286
효성대신아파트,41042,479,4590,461,4590,18,163
효성도서관,41420,2186,377,2158,377,28,82
효성동동화운수차고지,41573,11959,4088,11599,4088,360,517
효성명현초등학교,41065,4029,1045,3894,1045,135,163
효성사거리,41017,1367,4961,1284,4961,83,204
효성사거리,41018,12405,4890,12150,4890,255,557
효성사거리,41019,5371,7038,5272,7038,99,400
효성사거리,41631,1018,723,996,723,22,56
효성상아아파트,39357,14128,16835,13874,16835,254,998
효성상아아파트,39358,19110,13718,18820,13718,290,1058
효성서초등학교,41557,2707,429,2695,429,12,101
효성서초등학교,41558,426,2398,422,2398,4,91
효성서초등학교,41579,196,988,191,988,5,38
효성서초등학교,41580,1775,582,1766,582,9,76
효성성모병원,41022,5925,265,5760,265,165,199
효성소방파출소,41023,9347,3016,9170,3016,177,398
효성신사거리,41030,1602,8124,1485,8124,117,313
효성신사거리,41031,7626,1489,7416,1489,210,294
효성아파트,42166,9272,2763,9120,2763,152,388
효성아파트,42168,2828,7436,2779,7436,49,331
효성중앙교회,41021,166,7262,134,7262,32,239
효성프라자,41052,5841,8715,5673,8715,168,469
효성프라자,41055,6532,4126,6342,4126,190,343
효성현대3차,41049,1284,3420,1210,3420,74,151
효성현대3차아파트,41051,1056,657,1012,657,44,55
효성현대4차,41035,2946,4637,2739,4637,207,244
효성현대4차아파트,41036,4906,1879,4814,1879,92,218
효자교앞,90199,3,0,3,0,0,0
효자교앞,90200,13,15,13,15,0,0
효정아파트,38260,938,1698,933,1698,5,85
후정초등학교.삼산도서관,40685,44,1298,34,1298,10,43
후지테크,39051,2122,1345,2102,1345,20,111
후지테크,39052,421,1907,417,1907,4,75
후포항입구,43431,18,109,18,109,0,4
후포항입구,43481,37,24,28,24,9,1
휴먼시아1단지,40837,3902,6582,3793,6582,109,338
휴먼시아1단지,40838,6373,2414,6265,2414,108,283
휴먼시아1단지,40840,971,4,931,4,40,31
휴먼시아1단지,40852,460,2002,268,2002,192,79
휴먼시아후문,42885,10400,4147,10163,4147,237,469
흥륜사입구,38723,231,274,210,274,21,16
흥륜사입구,38724,168,227,163,227,5,12
흥성리,18804,3,216,3,216,0,7
흥성리,62029,230,8,229,8,1,7
흥왕2리마을회관 앞,43122,34,16,31,16,3,1
흥왕2리마을회관 앞,43520,32,41,31,41,1,2
흥왕리,90073,0,26,0,26,0,0
흥왕리,90074,10,3,8,3,2,0
흥왕상회,43502,42,43,42,43,0,2
흥왕상회,43516,37,2,32,2,5,1
희경산업·남동스카이장례식장,39031,164,95,160,95,4,8
희경산업·남동스카이장례식장,39961,16,324,15,324,1,10
희망찬요양병원,38126,4148,6457,4085,6457,63,342
희망천입구,40091,5712,5027,5574,5027,138,346
희망천입구,40799,6224,5781,6129,5781,95,387
희망체육공원입구,40912,5333,58,5069,58,264,173
희성금속,42018,78,539,78,539,0,19
힐데스하임,42876,10907,3196,10668,3196,239,454
힐스테이트,35457,16511,10696,16261,10696,250,877
힐스테이트,35458,6306,5692,6024,5692,282,387
힐스테이트레이크송도(후문),38630,2171,1905,2123,1905,48,131
힐스테이트레이크송도(후문),38656,2362,1792,2296,1792,66,134
힐스테이트레이크송도1차입구,38655,1001,1258,969,1258,32,72
힐스테이트레이크송도2차(201동),38641,1369,2011,1343,2011,26,109
힐스테이트레이크송도2차(201동),38657,1807,752,1778,752,29,82
힐스테이트송도더테라스(정문),38715,1127,212,1093,212,34,43
힐스테이트송도더테라스(정문),38716,193,649,189,649,4,27
힐스테이트송도더테라스(후문),38713,2580,2276,2503,2276,77,156
힐스테이트송도더테라스(후문),38714,595,2163,557,2163,38,88
힐스테이트푸르지오주안,37293,22431,32974,22013,32974,418,1787
힐스테이트학익,37022,5607,3910,5456,3910,151,307
힐스테이트학익,37023,3952,8067,3892,8067,60,387
힐스테이트학익104동앞,37669,846,1494,812,1494,34,75
힐스테이트학익104동앞,37670,1468,4570,1424,4570,44,194
힐캐슬프라자,39329,10858,15396,10649,15396,209,846
힐캐슬프라자,39331,17164,8776,16634,8776,530,836
힘찬병원,40891,5271,6885,5199,6885,72,392
힘찬병원,40892,4034,3093,3937,3093,97,229